nTeiAeuHrt = "nTeiAeuHrt",
JwseXEfkLg = "JwseXEfkLg",
onLzPMutqx = "onLzPMutqx",
hUqqeKBCuF = "hUqqeKBCuF",
vQtgrfxaEr = "vQtgrfxaEr",
gWwuBDyEMM = "gWwuBDyEMM",
SwYixkYPhN = "SwYixkYPhN",
AlOthawLoo = "AlOthawLoo",
vjXzstCwML = "vjXzstCwML",
aKyjQfjPue = "aKyjQfjPue",
eSjPXiZrEd = "eSjPXiZrEd",
vUQyrkkSmS = "vUQyrkkSmS",
ngPtgqQxnG = "ngPtgqQxnG",
MAvrbqDtBT = "MAvrbqDtBT",
ULqrDDarBD = "ULqrDDarBD",
MFbFhiHjeM = "MFbFhiHjeM",
QeUsrojEQh = "QeUsrojEQh",
TnABRRXltb = "TnABRRXltb",
hClGHuTpWd = "hClGHuTpWd",
qvBlgeVEOX = "qvBlgeVEOX",
HrBweuUrvs = "HrBweuUrvs",
tDjiCcaNED = "tDjiCcaNED",
MeJTwnepFI = "MeJTwnepFI",
hWCDoNKLgN = "hWCDoNKLgN",
xcOVuDeFtu = "xcOVuDeFtu",
wKNBrGHcUa = "wKNBrGHcUa",
geUtEaOelG = "geUtEaOelG",
dLegBhkSPY = "dLegBhkSPY",
oXrcmdKzcL = "oXrcmdKzcL",
eNkFbTFonC = "eNkFbTFonC",
qoaJarWGOD = "qoaJarWGOD",
KWKPACbPxh = "KWKPACbPxh",
ZhiVeBDFQu = "ZhiVeBDFQu",
QSepecRtEt = "QSepecRtEt",
xtZzgTlFWj = "xtZzgTlFWj",
OIWYLFxLtR = "OIWYLFxLtR",
jljhGGWJYb = "jljhGGWJYb",
PHfpxhyCoR = "PHfpxhyCoR",
PWJSVyQCJe = "PWJSVyQCJe",
iWLABTDsBd = "iWLABTDsBd",
YOONMOkKAu = "YOONMOkKAu",
lKKrZTDmUn = "lKKrZTDmUn",
YwXNrMAWhD = "YwXNrMAWhD",
UrVWntRHho = "UrVWntRHho",
kbrpBKHXPm = "kbrpBKHXPm",
zyrWmMRqie = "zyrWmMRqie",
xtRdqFDwyc = "xtRdqFDwyc",
pDdHARcKrr = "pDdHARcKrr",
FOiGbRrWdS = "FOiGbRrWdS",
lZDtRUQXYz = "lZDtRUQXYz",
uPOjMYSDQS = "uPOjMYSDQS",
dfQHCzHjWw = "dfQHCzHjWw",
rUktZpXJbY = "rUktZpXJbY",
VtUuRbMHeT = "VtUuRbMHeT",
wkFLSuvUNE = "wkFLSuvUNE",
FocArQIPAe = "FocArQIPAe",
rEBaJnFFRy = "rEBaJnFFRy",
pTRleAnPPZ = "pTRleAnPPZ",
sXpetsdRHK = "sXpetsdRHK",
IXBkBcAFos = "IXBkBcAFos",
jiuewclZVa = "jiuewclZVa",
zoYIkAeuzh = "zoYIkAeuzh",
sZgWmnAKpu = "sZgWmnAKpu",
ukPNqQapec = "ukPNqQapec",
MNOJiUkptx = "MNOJiUkptx",
tIQmwrbFYO = "tIQmwrbFYO",
gJstevTysh = "gJstevTysh",
dacjbJyFdk = "dacjbJyFdk",
jEBcwmitEC = "jEBcwmitEC",
TsOeehhnkf = "TsOeehhnkf",
TkztetGzrr = "TkztetGzrr",
wXpmfrPqOQ = "wXpmfrPqOQ",
DiutuJQtrS = "DiutuJQtrS",
lsaGTYZQEN = "lsaGTYZQEN",
OrRILBftJo = "OrRILBftJo",
JtAtnjrrUX = "JtAtnjrrUX",
xyvIvbeAFZ = "xyvIvbeAFZ",
riYaesbOJE = "riYaesbOJE",
WnKrooQheC = "WnKrooQheC",
IGvEJWVDNo = "IGvEJWVDNo",
trrsRePBtw = "trrsRePBtw",
RUEXOfXDmr = "RUEXOfXDmr",
MuQIZwHUHm = "MuQIZwHUHm",
pgXYCKYdDO = "pgXYCKYdDO",
pbJaIqXwNb = "pbJaIqXwNb",
JACbFtREXK = "JACbFtREXK",
JGrbJMoYEd = "JGrbJMoYEd",
XyCBzBZTxh = "XyCBzBZTxh",
DCAqeoUeKZ = "DCAqeoUeKZ",
iIiutBGtAt = "iIiutBGtAt",
HRgKmRhDJL = "HRgKmRhDJL",
nDzciSIySa = "nDzciSIySa",
uroJTcaeIN = "uroJTcaeIN",
IeButvBByo = "IeButvBByo",
QezSqMuunc = "QezSqMuunc",
iuDKduHCtM = "iuDKduHCtM",
cUVRDnEUCn = "cUVRDnEUCn",
TXJDguMoZE = "TXJDguMoZE",
UcnpHeukFY = "UcnpHeukFY",
ZpweJoqtjc = "ZpweJoqtjc",
cDTUMBTZqr = "cDTUMBTZqr",
uvlgStHhAQ = "uvlgStHhAQ",
bmBOekLXuz = "bmBOekLXuz",
vjRuuAtTte = "vjRuuAtTte",
GZISSkInZZ = "GZISSkInZZ",
bVmdvrHdrA = "bVmdvrHdrA",
uffJFRCmrl = "uffJFRCmrl",
fpgGcjxHpk = "fpgGcjxHpk",
tQsrnTSHTS = "tQsrnTSHTS",
DWZeLvtqDB = "DWZeLvtqDB",
uatqIipwxE = "uatqIipwxE",
RZrEuewxUE = "RZrEuewxUE",
fnQOfcvxtS = "fnQOfcvxtS",
DtOlEhPjIy = "DtOlEhPjIy",
TWLjgIuErq = "TWLjgIuErq",
VDlvBiwEfF = "VDlvBiwEfF",
logFQzhvTT = "logFQzhvTT",
pmDcPQdqex = "pmDcPQdqex",
DpePvGItmr = "DpePvGItmr",
vZfEQPgurO = "vZfEQPgurO",
uvWCQRwTBW = "uvWCQRwTBW",
trMyOWNZke = "trMyOWNZke",
YZqwuWFLnz = "YZqwuWFLnz",
drbFhmSjyG = "drbFhmSjyG",
oEcnRYHvOr = "oEcnRYHvOr",
sgQnJttBPv = "sgQnJttBPv",
DKrtccIMXI = "DKrtccIMXI",
MCtdeyzKgW = "MCtdeyzKgW",
ObqaTPWNVP = "ObqaTPWNVP",
pxBeemYGmq = "pxBeemYGmq",
XjrDbJtHlp = "XjrDbJtHlp",
udiifmGxQm = "udiifmGxQm",
jbSnYZxIYA = "jbSnYZxIYA",
TKOuQoiABZ = "TKOuQoiABZ",
nSNeWAATMA = "nSNeWAATMA",
iPtcALuDew = "iPtcALuDew",
bfVONfeicX = "bfVONfeicX",
DMWWtAuHnp = "DMWWtAuHnp",
cpmeRGrtiV = "cpmeRGrtiV",
YdDrMQflUT = "YdDrMQflUT",
sCqofCmeUa = "sCqofCmeUa",
IdDzPRluDE = "IdDzPRluDE",
cjWlvSXSZe = "cjWlvSXSZe",
zcyJykFWza = "zcyJykFWza",
NCeksGGTDX = "NCeksGGTDX",
CNtoZnWatn = "CNtoZnWatn",
tDNpeBuTVQ = "tDNpeBuTVQ",
oVAWrBdQQr = "oVAWrBdQQr",
gykDwJMMzr = "gykDwJMMzr",
uRSXWErrDj = "uRSXWErrDj",
DNaBeMKdVM = "DNaBeMKdVM",
zfidhuAaQs = "zfidhuAaQs",
rfcDveWEHg = "rfcDveWEHg",
hehrpBCMND = "hehrpBCMND",
jYpjPnurxF = "jYpjPnurxF",
XRexKtUtLb = "XRexKtUtLb",
RQtlIZwKyv = "RQtlIZwKyv",
sSLuZsIKGj = "sSLuZsIKGj",
fRYAQbtQcA = "fRYAQbtQcA",
RReNzfUotS = "RReNzfUotS",
IuEOPFTBiu = "IuEOPFTBiu",
wIzxpsekgu = "wIzxpsekgu",
pyARdbrnrU = "pyARdbrnrU",
HepvnrCudc = "HepvnrCudc",
aOFTRgvEyI = "aOFTRgvEyI",
HQfgrmiswh = "HQfgrmiswh",
nGBUtrbkjN = "nGBUtrbkjN",
eUjxptJMYw = "eUjxptJMYw",
oUpriUerNX = "oUpriUerNX",
vPYeZJTzeH = "vPYeZJTzeH",
nHeXSQNubN = "nHeXSQNubN",
KFLaVuVHAG = "KFLaVuVHAG",
LWGlmlkXjx = "LWGlmlkXjx",
SYsvUmytzG = "SYsvUmytzG",
elOpTTRSDH = "elOpTTRSDH",
ebeAHOrBtM = "ebeAHOrBtM",
ZtQrFmBCxA = "ZtQrFmBCxA",
ioqHWnAHer = "ioqHWnAHer",
reYUjUHGCj = "reYUjUHGCj",
RXUvNtYtGA = "RXUvNtYtGA",
xrvfhtSeOA = "xrvfhtSeOA",
nruifBujnU = "nruifBujnU",
BgSeHnZVzk = "BgSeHnZVzk",
nsKmfGUgqQ = "nsKmfGUgqQ",
fBoNrthuNF = "fBoNrthuNF",
KWguXGerSL = "KWguXGerSL",
ewuNFEkdbk = "ewuNFEkdbk",
HdFceupUtQ = "HdFceupUtQ",
mqnPhTXdvc = "mqnPhTXdvc",
EoVmjDLzks = "EoVmjDLzks",
GSqZZdTIAR = "GSqZZdTIAR",
iSSrULCMqU = "iSSrULCMqU",
hhPwAottKP = "hhPwAottKP",
DNIhDTTfsy = "DNIhDTTfsy",
ewgnSiqhsH = "ewgnSiqhsH",
ahsuJxUhIQ = "ahsuJxUhIQ",
NgzUFGOwIt = "NgzUFGOwIt",
mNfyUwwtpK = "mNfyUwwtpK",
LiIdxKItGk = "LiIdxKItGk",
byTJBmiWnt = "byTJBmiWnt",
GnOPUwfDqz = "GnOPUwfDqz",
ccGcjhQjcu = "ccGcjhQjcu",
MuwxuBrfEp = "MuwxuBrfEp",
mtpaNrKKDP = "mtpaNrKKDP",
vCUjdJLnpa = "vCUjdJLnpa",
JwcGdyiGns = "JwcGdyiGns",
FeMsZRZPYP = "FeMsZRZPYP",
VHFJmnVKrS = "VHFJmnVKrS",
LLrXrMyRKZ = "LLrXrMyRKZ",
erRevmiWAi = "erRevmiWAi",
AIguSqZuLu = "AIguSqZuLu",
WhonmkIkJE = "WhonmkIkJE",
YjLRuGTLey = "YjLRuGTLey",
eHaDdJUMUY = "eHaDdJUMUY",
FiUuPYWrrk = "FiUuPYWrrk",
jadtgUGdrH = "jadtgUGdrH",
IRZaKMPlNo = "IRZaKMPlNo",
WulWtJuFPO = "WulWtJuFPO",
jCdWmYdgsF = "jCdWmYdgsF",
KPwHfebjaQ = "KPwHfebjaQ",
lKaeIjwOBU = "lKaeIjwOBU",
yvetePRwnp = "yvetePRwnp",
cBRddXoyJh = "cBRddXoyJh",
uvtdGtdmej = "uvtdGtdmej",
ipdiIlLVEE = "ipdiIlLVEE",
sxlFstHmqj = "sxlFstHmqj",
fbVLoQsZrA = "fbVLoQsZrA",
TtOZtNalZz = "TtOZtNalZz",
shQOglfRua = "shQOglfRua",
KaxoCtBKFt = "KaxoCtBKFt",
rugtsfroEh = "rugtsfroEh",
rARdJwIJwT = "rARdJwIJwT",
PtuubVleJT = "PtuubVleJT",
xWoIryFFiW = "xWoIryFFiW",
IoTetgbTvn = "IoTetgbTvn",
LGzamcREtV = "LGzamcREtV",
BzQephUrpV = "BzQephUrpV",
vpyJtTEBNV = "vpyJtTEBNV",
uBtAvGmFPB = "uBtAvGmFPB",
bPhOmotVtP = "bPhOmotVtP",
keZzqSqfrs = "keZzqSqfrs",
PcgNOtkzry = "PcgNOtkzry",
iowDUYkcEm = "iowDUYkcEm",
cofsZapLRl = "cofsZapLRl",
TnJgMoXPRI = "TnJgMoXPRI",
uMmgtzWEuQ = "uMmgtzWEuQ",
mZfbNRpOUR = "mZfbNRpOUR",
PaZRAANDnQ = "PaZRAANDnQ",
UymvdNsUEv = "UymvdNsUEv",
LHZurWzeee = "LHZurWzeee",
EtVIeMtrTV = "EtVIeMtrTV",
IoWCfxaeTh = "IoWCfxaeTh",
ClAaGRlvZa = "ClAaGRlvZa",
uslasfpgxb = "uslasfpgxb",
tTdeupuozr = "tTdeupuozr",
vzHNDwFxQe = "vzHNDwFxQe",
jzKBXyKuDL = "jzKBXyKuDL",
PELdJkOHLl = "PELdJkOHLl",
CpOegKufZC = "CpOegKufZC",
zqnutGMmMJ = "zqnutGMmMJ",
xKInVexKcu = "xKInVexKcu",
yimlyarxED = "yimlyarxED",
bdYWqBAgzG = "bdYWqBAgzG",
JzfTxVMKYv = "JzfTxVMKYv",
JSEhIWSdSS = "JSEhIWSdSS",
UytCntzODU = "UytCntzODU",
qHZFPEHLUt = "qHZFPEHLUt",
vmvdbTmlgr = "vmvdbTmlgr",
IppdHWnyab = "IppdHWnyab",
MdykQttgrY = "MdykQttgrY",
fkZQhGqDlw = "fkZQhGqDlw",
GWLDcrWZQh = "GWLDcrWZQh",
oDEudrrewV = "oDEudrrewV",
JfnSrCwGpO = "JfnSrCwGpO",
IbYnqFIYuO = "IbYnqFIYuO",
ILUTNeiwYV = "ILUTNeiwYV",
apZxIvgjug = "apZxIvgjug",
dzbudQTrtM = "dzbudQTrtM",
fFqFTGfsdo = "fFqFTGfsdo",
raHeMIkynJ = "raHeMIkynJ",
rieUmattlu = "rieUmattlu",
xfPavxUWLZ = "xfPavxUWLZ",
mFivlsldeQ = "mFivlsldeQ",
twzjgcUxYM = "twzjgcUxYM",
QSnJfDTqNs = "QSnJfDTqNs",
OnCCprKGFh = "OnCCprKGFh",
kGrfvlOPyr = "kGrfvlOPyr",
ZUpcOCCFhR = "ZUpcOCCFhR",
tEHHYJLRDb = "tEHHYJLRDb",
OZkjzHuSIl = "OZkjzHuSIl",
THPgaJNBar = "THPgaJNBar",
sAwRqizkau = "sAwRqizkau",
qjLaosMfhU = "qjLaosMfhU",
rUfJfXjEyu = "rUfJfXjEyu",
BPIBMOxvOL = "BPIBMOxvOL",
PCueHvFSoZ = "PCueHvFSoZ",
otFclCKhbt = "otFclCKhbt",
sYMYDJGAQT = "sYMYDJGAQT",
KmEPOnqkki = "KmEPOnqkki",
dngGikOKKd = "dngGikOKKd",
YtShTKPQCH = "YtShTKPQCH",
puGmtUuhys = "puGmtUuhys",
ZAKHGGfCDe = "ZAKHGGfCDe",
dHMbCcuOTZ = "dHMbCcuOTZ",
qPqnyXdsmW = "qPqnyXdsmW",
hjHzYVrlTH = "hjHzYVrlTH",
wXNvcNHcvC = "wXNvcNHcvC",
trVFEphVPx = "trVFEphVPx",
RdhQopuUhW = "RdhQopuUhW",
KtvmtuuFtp = "KtvmtuuFtp",
rLwEZzVpnX = "rLwEZzVpnX",
ZWBtIDUhFB = "ZWBtIDUhFB",
rsTPnYsXzr = "rsTPnYsXzr",
tIuAtBnXtU = "tIuAtBnXtU",
TkNyxJUxlm = "TkNyxJUxlm",
QArujdVzPw = "QArujdVzPw",
acosTOVQkr = "acosTOVQkr",
jyghMGrrVH = "jyghMGrrVH",
rnVmvTkYkP = "rnVmvTkYkP",
eDPPCwcaur = "eDPPCwcaur",
ExGHfcdgLj = "ExGHfcdgLj",
ireLutPqcG = "ireLutPqcG",
JxLBPIhfso = "JxLBPIhfso",
igjWQanFxX = "igjWQanFxX",
IcSgpGpteH = "IcSgpGpteH",
TmesthcuYz = "TmesthcuYz",
yYGIAOrbZw = "yYGIAOrbZw",
HNMtyROjEl = "HNMtyROjEl",
evkugevXwc = "evkugevXwc",
qvQeLhrXTQ = "qvQeLhrXTQ",
JAFPhTNKlB = "JAFPhTNKlB",
ajAfMIZmuG = "ajAfMIZmuG",
BoytjPlPYY = "BoytjPlPYY",
EXrcUNupXD = "EXrcUNupXD",
NArRGqaxpd = "NArRGqaxpd",
xbofDsboHc = "xbofDsboHc",
HunALNdkID = "HunALNdkID",
CZfPCpkKVY = "CZfPCpkKVY",
TuckArLzqw = "TuckArLzqw",
AOqjfVybZA = "AOqjfVybZA",
hpnxFMwdoU = "hpnxFMwdoU",
rweutgSuLL = "rweutgSuLL",
azqKTVlyWw = "azqKTVlyWw",
sWgAoFidRc = "sWgAoFidRc",
vvuSecufMs = "vvuSecufMs",
oEcTCYWOUA = "oEcTCYWOUA",
TLyyfCcJRw = "TLyyfCcJRw",
TruePTetPM = "TruePTetPM",
mbOdbaeuSm = "mbOdbaeuSm",
ljueTCFJmQ = "ljueTCFJmQ",
noItQpoALW = "noItQpoALW",
eDLctCQnar = "eDLctCQnar",
XtrefGJtYq = "XtrefGJtYq",
mrsPlrzhmB = "mrsPlrzhmB",
lvEqNYkRGH = "lvEqNYkRGH",
lxRtFScDPr = "lxRtFScDPr",
OlDrmueRmA = "OlDrmueRmA",
cZDUYaoXPP = "cZDUYaoXPP",
fLOjeIYqSd = "fLOjeIYqSd",
uhQwjxriye = "uhQwjxriye",
IycnyQccsI = "IycnyQccsI",
PMSACerJRO = "PMSACerJRO",
uBeTMCtULp = "uBeTMCtULp",
htgSHxDxih = "htgSHxDxih",
kuJClRgHru = "kuJClRgHru",
nkytlKOoKC = "nkytlKOoKC",
eOCMaemPJI = "eOCMaemPJI",
sbbWPiIWEX = "sbbWPiIWEX",
eSjVUOYbCt = "eSjVUOYbCt",
tTaTFrRUAY = "tTaTFrRUAY",
SUZNTDshsk = "SUZNTDshsk",
LIHhXDiKNM = "LIHhXDiKNM",
PrkxRXCOML = "PrkxRXCOML",
KsDmUijybm = "KsDmUijybm",
svfFqRopeD = "svfFqRopeD",
BWQpdGtKjL = "BWQpdGtKjL",
VsMUFAMfeV = "VsMUFAMfeV",
xEqFLQhSQe = "xEqFLQhSQe",
tztpBgTpCw = "tztpBgTpCw",
xTJNKXkeRP = "xTJNKXkeRP",
jzHnVUfTvd = "jzHnVUfTvd",
RgitAxLkNN = "RgitAxLkNN",
ASAWIPqINz = "ASAWIPqINz",
vCrSOlxatf = "vCrSOlxatf",
JojFHeMCce = "JojFHeMCce",
ZGVEXGdSGm = "ZGVEXGdSGm",
eNUeWdNJxe = "eNUeWdNJxe",
GuIBMgmqRS = "GuIBMgmqRS",
RGYRJremgm = "RGYRJremgm",
LOnxxYtoaq = "LOnxxYtoaq",
wofmbqhhto = "wofmbqhhto",
DIsDUfywpC = "DIsDUfywpC",
LQkdJtyXEX = "LQkdJtyXEX",
noxHOHEnVn = "noxHOHEnVn",
gbKWwYcXKp = "gbKWwYcXKp",
BUBsAvLQCC = "BUBsAvLQCC",
UcnfqBukGS = "UcnfqBukGS",
tmtAIMIWpP = "tmtAIMIWpP",
GssSzjdDBQ = "GssSzjdDBQ",
ujyCdatxVM = "ujyCdatxVM",
Vgunwwtwbk = "Vgunwwtwbk",
WDuJlNZLPa = "WDuJlNZLPa",
xiZcuVbacl = "xiZcuVbacl",
GYYqkItrIB = "GYYqkItrIB",
DGtrCtCkPv = "DGtrCtCkPv",
gDMwgEtSmc = "gDMwgEtSmc",
GQeaLZeAxG = "GQeaLZeAxG",
mdJsZHMSWz = "mdJsZHMSWz",
eHAtcotxuG = "eHAtcotxuG",
tHPepPfjHB = "tHPepPfjHB",
eHJEicZBOt = "eHJEicZBOt",
eVaJNKQaeA = "eVaJNKQaeA",
xmSrmgdrFa = "xmSrmgdrFa",
JVougOXSba = "JVougOXSba",
KwGRsyiguN = "KwGRsyiguN",
strfDTljef = "strfDTljef",
HrtpayCSlZ = "HrtpayCSlZ",
iqeRdoXUgj = "iqeRdoXUgj",
TaOUJtDJUZ = "TaOUJtDJUZ",
RciTfxQnkN = "RciTfxQnkN",
MsqZefthqk = "MsqZefthqk",
JdDlrYNmes = "JdDlrYNmes",
uBrvxGkLFm = "uBrvxGkLFm",
mimoxdTIVN = "mimoxdTIVN",
xqPVFyESdG = "xqPVFyESdG",
mChpeBlpBb = "mChpeBlpBb",
XerWRFHjjw = "XerWRFHjjw",
pZhurEgksl = "pZhurEgksl",
ZyyBWzExvN = "ZyyBWzExvN",
lrWeoreueJ = "lrWeoreueJ",
SmtGiTLvfk = "SmtGiTLvfk",
sKBiyvvpHW = "sKBiyvvpHW",
kMerWuSlWv = "kMerWuSlWv",
KpuoGFSgfU = "KpuoGFSgfU",
JVfIoCYqfC = "JVfIoCYqfC",
bexcOFMOar = "bexcOFMOar",
hpeeVmnoxZ = "hpeeVmnoxZ",
ffiNCaPeaB = "ffiNCaPeaB",
ACiKmxazns = "ACiKmxazns",
QfGVktyldm = "QfGVktyldm",
uVxtsattdK = "uVxtsattdK",
LrHHmCNelz = "LrHHmCNelz",
EKAdgnqQzV = "EKAdgnqQzV",
pgkttrWAPe = "pgkttrWAPe",
qJpxVwyhWu = "qJpxVwyhWu",
rSYDYeRjOy = "rSYDYeRjOy",
lLjuZcKSIQ = "lLjuZcKSIQ",
ZtiBufrmXk = "ZtiBufrmXk",
mtfYmBZuon = "mtfYmBZuon",
kigPYMorVO = "kigPYMorVO",
XeWqlTNyOT = "XeWqlTNyOT",
NMjRyriHhR = "NMjRyriHhR",
bTPJlRtISF = "bTPJlRtISF",
rYIQtisQle = "rYIQtisQle",
zQrPfQpthT = "zQrPfQpthT",
ZUiwNQtSvB = "ZUiwNQtSvB",
plKrdpmryY = "plKrdpmryY",
MWzZByzvWI = "MWzZByzvWI",
pluUmBwvmw = "pluUmBwvmw",
UoKsVkoCKi = "UoKsVkoCKi",
RfLqimzryv = "RfLqimzryv",
DzRXPrvuzr = "DzRXPrvuzr",
EgtMPFtyZN = "EgtMPFtyZN",
raMJNevoYk = "raMJNevoYk",
dIFNenDleD = "dIFNenDleD",
lKvurtfCyn = "lKvurtfCyn",
IePYAImQtw = "IePYAImQtw",
WCxhIVkTeQ = "WCxhIVkTeQ",
ItwNiYGSWN = "ItwNiYGSWN",
YceXljGWbO = "YceXljGWbO",
MLjoeavLYx = "MLjoeavLYx",
dlySnEDqvV = "dlySnEDqvV",
JRnueSeaRp = "JRnueSeaRp",
aIQKMyHwqU = "aIQKMyHwqU",
tYtZeUNeOk = "tYtZeUNeOk",
ugYBtwvrYe = "ugYBtwvrYe",
YxfRleSlnR = "YxfRleSlnR",
biqsVSJhNl = "biqsVSJhNl",
eWvJUuBrhW = "eWvJUuBrhW",
sbKSLtkzqO = "sbKSLtkzqO",
sBueUuOvVH = "sBueUuOvVH",
rKnjudngFq = "rKnjudngFq",
ooEbKpHOVj = "ooEbKpHOVj",
rwxpclVLeK = "rwxpclVLeK",
meEQnGexmR = "meEQnGexmR",
SrtDYyPHeK = "SrtDYyPHeK",
XtYisSLTJg = "XtYisSLTJg",
OpkCZaQePd = "OpkCZaQePd",
EwkDnEjPxZ = "EwkDnEjPxZ",
ccZyWYoqzf = "ccZyWYoqzf",
FWQiZEIBQK = "FWQiZEIBQK",
zoULMXSjmM = "zoULMXSjmM",
UDeeSsGVhA = "UDeeSsGVhA",
CkeyvIndcn = "CkeyvIndcn",
XAMXORYdvc = "XAMXORYdvc",
iMWYoevBrA = "iMWYoevBrA",
nlecZXVtRL = "nlecZXVtRL",
egpofuZJdp = "egpofuZJdp",
ZtwSjAdTCT = "ZtwSjAdTCT",
rvhEiueKyt = "rvhEiueKyt",
kDzDESuTMt = "kDzDESuTMt",
BaSkxlZhjf = "BaSkxlZhjf",
rcyZSeuSSC = "rcyZSeuSSC",
gJFjcKeqmJ = "gJFjcKeqmJ",
MXObkopDrt = "MXObkopDrt",
LezuSgsOuv = "LezuSgsOuv",
nhLHCnoYWG = "nhLHCnoYWG",
LjzdIgbini = "LjzdIgbini",
UVYucWXlAy = "UVYucWXlAy",
LwowgLJJEU = "LwowgLJJEU",
uuYZreoRuP = "uuYZreoRuP",
ZJtxtxeVIP = "ZJtxtxeVIP",
yurxWBbFTw = "yurxWBbFTw",
kijmYSrjrW = "kijmYSrjrW",
mLVYofPBLo = "mLVYofPBLo",
sdzinWeRRb = "sdzinWeRRb",
sHzFdrihlk = "sHzFdrihlk",
UMcEXrnBUI = "UMcEXrnBUI",
LVPoPuRurt = "LVPoPuRurt",
DKpPukXrgM = "DKpPukXrgM",
NJBNKeUudJ = "NJBNKeUudJ",
tlVtZLOuWf = "tlVtZLOuWf",
nvqfDryger = "nvqfDryger",
DEOXylPBlO = "DEOXylPBlO",
yXyoBsXYOB = "yXyoBsXYOB",
eOaRiRucXh = "eOaRiRucXh",
fVsTKNsSHy = "fVsTKNsSHy",
wNetYeUFeA = "wNetYeUFeA",
VXDInDVUeC = "VXDInDVUeC",
ViilQzVIAF = "ViilQzVIAF",
rtAShsEdFg = "rtAShsEdFg",
egrCKtxpRp = "egrCKtxpRp",
nVxCMMreok = "nVxCMMreok",
ofrnWVFfaA = "ofrnWVFfaA",
MXEiceKkWc = "MXEiceKkWc",
tdskMiQgQC = "tdskMiQgQC",
VheRZagBdR = "VheRZagBdR",
fACUhMZUmJ = "fACUhMZUmJ",
WOfMNebpFN = "WOfMNebpFN",
DPDcemvVgg = "DPDcemvVgg",
jotdZsMoql = "jotdZsMoql",
xECSglhNrF = "xECSglhNrF",
mUXuXCrwmm = "mUXuXCrwmm",
VmhSGlLWrF = "VmhSGlLWrF",
YZcXrnzejO = "YZcXrnzejO",
EubptrBlUl = "EubptrBlUl",
PryeKUXeOU = "PryeKUXeOU",
FgDVrIeeiP = "FgDVrIeeiP",
WquceXceXT = "WquceXceXT",
KuXsXPDtiH = "KuXsXPDtiH",
joruLuUkyE = "joruLuUkyE",
GbEfmbcEmC = "GbEfmbcEmC",
tsHuuhXyDL = "tsHuuhXyDL",
PlcBACqgcO = "PlcBACqgcO",
oczxjhatgB = "oczxjhatgB",
FxlIIAVZFB = "FxlIIAVZFB",
kvglDzjaFd = "kvglDzjaFd",
KCzQgealUn = "KCzQgealUn",
eXqLrVbdey = "eXqLrVbdey",
QGfDynvLiu = "QGfDynvLiu",
QuKUrVulLu = "QuKUrVulLu",
rIBuvRszrI = "rIBuvRszrI",
qyfjqeeduf = "qyfjqeeduf",
FZiorKSUHR = "FZiorKSUHR",
jartBmsDYu = "jartBmsDYu",
retzuTuUse = "retzuTuUse",
YgfeKzuNzQ = "YgfeKzuNzQ",
JriehvnvrH = "JriehvnvrH",
MBytihManY = "MBytihManY",
DXhBYQzSwd = "DXhBYQzSwd",
PRBhtrHAVr = "PRBhtrHAVr",
LpGIQjyVTt = "LpGIQjyVTt",
bRTERwEkmN = "bRTERwEkmN",
mQhzOhbVRo = "mQhzOhbVRo",
ESTYINKIvd = "ESTYINKIvd",
ytTsHWwbAW = "ytTsHWwbAW",
eTHJfqruoy = "eTHJfqruoy",
LWtHlTniXD = "LWtHlTniXD",
rmCoUGFtoM = "rmCoUGFtoM",
geFdhlriuZ = "geFdhlriuZ",
LnvHgHfHeM = "LnvHgHfHeM",
cfLcvOXtLt = "cfLcvOXtLt",
YrVzPQZBmw = "YrVzPQZBmw",
jrXSuqrtOO = "jrXSuqrtOO",
mvvpCOqwvY = "mvvpCOqwvY",
QtKuxOOLzh = "QtKuxOOLzh",
EEtEAhRNGa = "EEtEAhRNGa",
FfHunwEsLl = "FfHunwEsLl",
xEpgOcmgjF = "xEpgOcmgjF",
XzlGYeEQHe = "XzlGYeEQHe",
JkqUGyorBT = "JkqUGyorBT",
WIXgUpMGVh = "WIXgUpMGVh",
MSbJdAtGvB = "MSbJdAtGvB",
ltcOQeeYqo = "ltcOQeeYqo",
IVUuRWyWxJ = "IVUuRWyWxJ",
pefndtiBPD = "pefndtiBPD",
VczrSZoeAd = "VczrSZoeAd",
XNrJuriLcN = "XNrJuriLcN",
GefTxMOAIO = "GefTxMOAIO",
ZCeNrdFeUE = "ZCeNrdFeUE",
KKqrdXCWDg = "KKqrdXCWDg",
XtjjknWOel = "XtjjknWOel",
frwoNVRxyV = "frwoNVRxyV",
SDtVKczOAb = "SDtVKczOAb",
hkvHqgNjFI = "hkvHqgNjFI",
etZkkhpECu = "etZkkhpECu",
NtoVpohrvN = "NtoVpohrvN",
mgDyFOYYeN = "mgDyFOYYeN",
oNNivqTSfG = "oNNivqTSfG",
zPCFDuzYaZ = "zPCFDuzYaZ",
wnhMSkyKKA = "wnhMSkyKKA",
zwEVtXdCLM = "zwEVtXdCLM",
dRDoQgmJmH = "dRDoQgmJmH",
incjzdglKb = "incjzdglKb",
UCMvrhtyCs = "UCMvrhtyCs",
VAtSursSiz = "VAtSursSiz",
NiTSthIpdo = "NiTSthIpdo",
LeQFwfDuAr = "LeQFwfDuAr",
PCVJmNwtLl = "PCVJmNwtLl",
vTFFJaifnG = "vTFFJaifnG",
rdvMPrkqOg = "rdvMPrkqOg",
WMjUtonisq = "WMjUtonisq",
BQrrcgSILB = "BQrrcgSILB",
uDHDNGzdaU = "uDHDNGzdaU",
EonIcGUftX = "EonIcGUftX",
XKBuuZROHr = "XKBuuZROHr",
XOkbuttsPD = "XOkbuttsPD",
TofCNmzpcP = "TofCNmzpcP",
LyKZGdNGqG = "LyKZGdNGqG",
BneyNNRViY = "BneyNNRViY",
DuWdhNYCXv = "DuWdhNYCXv",
fJlcIZKrwy = "fJlcIZKrwy",
odKPgtsltQ = "odKPgtsltQ",
tuuuOGRBuR = "tuuuOGRBuR",
YLaUcWarpq = "YLaUcWarpq",
XmFRjuSTWe = "XmFRjuSTWe",
XHrRIxLDTt = "XHrRIxLDTt",
xAAHGyDtJW = "xAAHGyDtJW",
fGsOpMxdSe = "fGsOpMxdSe",
mhDauoUKVM = "mhDauoUKVM",
FcwJkfuaRi = "FcwJkfuaRi",
rWFNjsqbmu = "rWFNjsqbmu",
SqsDzlspPw = "SqsDzlspPw",
cWmBmEAYsw = "cWmBmEAYsw",
QicaqUfsvB = "QicaqUfsvB",
jwXvXafEyd = "jwXvXafEyd",
eIWSbrABbb = "eIWSbrABbb",
BPeHXrJglr = "BPeHXrJglr",
ocnUTAJrtc = "ocnUTAJrtc",
bvfGPVttjb = "bvfGPVttjb",
WvqzSEjHjc = "WvqzSEjHjc",
QvLvabKesL = "QvLvabKesL",
oPgeDWmKPj = "oPgeDWmKPj",
SfdfbiJIJb = "SfdfbiJIJb",
qHNSWHyPAj = "qHNSWHyPAj",
jVKmAuHSjg = "jVKmAuHSjg",
pwwkgZqcpJ = "pwwkgZqcpJ",
uKoeDilhxF = "uKoeDilhxF",
RubIZitQFJ = "RubIZitQFJ",
ztwUYeKArv = "ztwUYeKArv",
ENQdDNhzAh = "ENQdDNhzAh",
GALDtmHKqd = "GALDtmHKqd",
PuSjxCCyCP = "PuSjxCCyCP",
ieJeWrDSOr = "ieJeWrDSOr",
eNGZcrbpms = "eNGZcrbpms",
VtvcCxDWjc = "VtvcCxDWjc",
AFEejpGeTh = "AFEejpGeTh",
ByUjqwIOGh = "ByUjqwIOGh",
GDfIqNRPxr = "GDfIqNRPxr",
XzATueuthf = "XzATueuthf",
PspXFZTRGG = "PspXFZTRGG",
NubftTkCum = "NubftTkCum",
luMaOxLYte = "luMaOxLYte",
DMoICuqZHl = "DMoICuqZHl",
AVrqwuIuDI = "AVrqwuIuDI",
KvnxoteYTX = "KvnxoteYTX",
bLiHuarKJn = "bLiHuarKJn",
YMBUfJuCGY = "YMBUfJuCGY",
ujtOjwjrtL = "ujtOjwjrtL",
QpePqtxaOY = "QpePqtxaOY",
duDtwcuMMv = "duDtwcuMMv",
VfYPRmLIpO = "VfYPRmLIpO",
lacrEldStw = "lacrEldStw",
YJupLELNzB = "YJupLELNzB",
FwgoBwBZZz = "FwgoBwBZZz",
phgllPGtbu = "phgllPGtbu",
QtomeQyuOt = "QtomeQyuOt",
BnJfKfEAIb = "BnJfKfEAIb",
XanGVKwouT = "XanGVKwouT",
OeBaOliieV = "OeBaOliieV",
TuYPHjTuta = "TuYPHjTuta",
GEwuKwTmNZ = "GEwuKwTmNZ",
ZaeMFVaJza = "ZaeMFVaJza",
htrLQCatoe = "htrLQCatoe",
WIXohHsJUn = "WIXohHsJUn",
lHGQYcvzOI = "lHGQYcvzOI",
GiOuFtEfde = "GiOuFtEfde",
DipuaBGXxD = "DipuaBGXxD",
CNtnPruDsc = "CNtnPruDsc",
pXHbAknyXF = "pXHbAknyXF",
fekvYzDHNf = "fekvYzDHNf",
yfUuTGhiyS = "yfUuTGhiyS",
lCuYeWOolg = "lCuYeWOolg",
YKpfxGkVpk = "YKpfxGkVpk",
rSXnVeDkTH = "rSXnVeDkTH",
TJJPNLxevO = "TJJPNLxevO",
sYnmuOntRl = "sYnmuOntRl",
caArWlfoxl = "caArWlfoxl",
tiRyyiOmQc = "tiRyyiOmQc",
LvMJXxJmeO = "LvMJXxJmeO",
hVtvFSMPfD = "hVtvFSMPfD",
OuPqrEqfDV = "OuPqrEqfDV",
OtQvKaVesZ = "OtQvKaVesZ",
iyeDQNIeUr = "iyeDQNIeUr",
dvafGnKzyf = "dvafGnKzyf",
kslawuDxMm = "kslawuDxMm",
ocuuTfqJbl = "ocuuTfqJbl",
xeEunybARa = "xeEunybARa",
OXDGwAnrPz = "OXDGwAnrPz",
PAXtiguiwJ = "PAXtiguiwJ",
BWOVpwgOdt = "BWOVpwgOdt",
ZJXjGZVYsa = "ZJXjGZVYsa",
QCkKKiabef = "QCkKKiabef",
eZthIDddBy = "eZthIDddBy",
QRzcKrScRu = "QRzcKrScRu",
SXgdKHJcPf = "SXgdKHJcPf",
bqYNrDxHtr = "bqYNrDxHtr",
mxqCoJQvKb = "mxqCoJQvKb",
lkPjBKrQfF = "lkPjBKrQfF",
BQayvUwYJu = "BQayvUwYJu",
UciujLoPJj = "UciujLoPJj",
mtrnuWdzNA = "mtrnuWdzNA",
lBAkstronR = "lBAkstronR",
ftiYnyhaBP = "ftiYnyhaBP",
cHLfsDHZtV = "cHLfsDHZtV",
lRTqWmeyhN = "lRTqWmeyhN",
PfmKejuruH = "PfmKejuruH",
rueqhXtyam = "rueqhXtyam",
GRtgRVhRou = "GRtgRVhRou",
tWAKfehsEG = "tWAKfehsEG",
eEjAwjvZBX = "eEjAwjvZBX",
xzecKspdgr = "xzecKspdgr",
vyKTWqficL = "vyKTWqficL",
MvoiVOuHan = "MvoiVOuHan",
ZisSeagDGL = "ZisSeagDGL",
rSnfCXDPpe = "rSnfCXDPpe",
JQgFEJTuVa = "JQgFEJTuVa",
GohDyuVMUi = "GohDyuVMUi",
iHuHrmnkLh = "iHuHrmnkLh",
IytNgakDjn = "IytNgakDjn",
tmTsmuOmrC = "tmTsmuOmrC",
BjfmmtdmTu = "BjfmmtdmTu",
olZgBrbXpG = "olZgBrbXpG",
OIgQlSRCtU = "OIgQlSRCtU",
ArBbZApuBj = "ArBbZApuBj",
FTfEZrXMFe = "FTfEZrXMFe",
JOwuUByeUo = "JOwuUByeUo",
mOoTDFIrKf = "mOoTDFIrKf",
BtHybfcdaU = "BtHybfcdaU",
mroCFoGdbo = "mroCFoGdbo",
ijaiflnKJj = "ijaiflnKJj",
ajdiunKdlm = "ajdiunKdlm",
iaNKUeZpfj = "iaNKUeZpfj",
roHUMeKeoc = "roHUMeKeoc",
FcMcecvTua = "FcMcecvTua",
MkbVnmaYPj = "MkbVnmaYPj",
vfSFAtMKPY = "vfSFAtMKPY",
DPgnAxGEjC = "DPgnAxGEjC",
SufUXwRcNF = "SufUXwRcNF",
kTlkGZrTdo = "kTlkGZrTdo",
pxocZPpsIu = "pxocZPpsIu",
RtKNHWAAze = "RtKNHWAAze",
BSYPqGMZxS = "BSYPqGMZxS",
tYJCTBNwel = "tYJCTBNwel",
TvfGnbLEXW = "TvfGnbLEXW",
iUFSfkBApH = "iUFSfkBApH",
eTAMuRYHPP = "eTAMuRYHPP",
dAVyRkRdur = "dAVyRkRdur",
eotxXDoqOb = "eotxXDoqOb",
zYgNPrORrd = "zYgNPrORrd",
DqbzFjdJTr = "DqbzFjdJTr",
NsErATPzSK = "NsErATPzSK",
oirLRxrdXd = "oirLRxrdXd",
CYBhEWLjPR = "CYBhEWLjPR",
zKVrwYAAws = "zKVrwYAAws",
dqUmMaNxtx = "dqUmMaNxtx",
gxnUXuhgrD = "gxnUXuhgrD",
NSpGTFktTZ = "NSpGTFktTZ",
hwWvfbfSwG = "hwWvfbfSwG",
RNuRtpgatv = "RNuRtpgatv",
aUHGTclrvC = "aUHGTclrvC",
ofMZcleoVa = "ofMZcleoVa",
hujlugQgWg = "hujlugQgWg",
urnScfkMRu = "urnScfkMRu",
udQPHunAqP = "udQPHunAqP",
vOgHGrgajA = "vOgHGrgajA",
bPTQabDgDf = "bPTQabDgDf",
UEiBRkpVdX = "UEiBRkpVdX",
izyBJTvxzA = "izyBJTvxzA",
WvyrXrWXRh = "WvyrXrWXRh",
qmaCqFHfpg = "qmaCqFHfpg",
VrSRvxmdWq = "VrSRvxmdWq",
rNfXevsQra = "rNfXevsQra",
JmmlGZlwzH = "JmmlGZlwzH",
rgXCkKeenL = "rgXCkKeenL",
HArrbAzhXD = "HArrbAzhXD",
betbYuQunQ = "betbYuQunQ",
cFeoRfoiLj = "cFeoRfoiLj",
JvhDoItgRh = "JvhDoItgRh",
beUqToyTtu = "beUqToyTtu",
soEVAfzZUG = "soEVAfzZUG",
KtGDjnKAqv = "KtGDjnKAqv",
ZEPyeiGKrh = "ZEPyeiGKrh",
sKTuTgFpbh = "sKTuTgFpbh",
LcvRpdFZBU = "LcvRpdFZBU",
vMQvuwthJw = "vMQvuwthJw",
jJWvkjabAE = "jJWvkjabAE",
NJBUPabuiY = "NJBUPabuiY",
OeEEVxrlmS = "OeEEVxrlmS",
UrVYowHcGN = "UrVYowHcGN",
upSKyWXrgP = "upSKyWXrgP",
CyiOBUjSPu = "CyiOBUjSPu",
KeQjfnEsVd = "KeQjfnEsVd",
nRujZZuyDL = "nRujZZuyDL",
IvFIwkYuSN = "IvFIwkYuSN",
OnUoaVuSto = "OnUoaVuSto",
Awkqkcwtgq = "Awkqkcwtgq",
kXKWEPzLLS = "kXKWEPzLLS",
jSyTjXePJk = "jSyTjXePJk",
bRrWxIfeAK = "bRrWxIfeAK",
guwYptaJhk = "guwYptaJhk",
PgtyiGneiA = "PgtyiGneiA",
ZQroxQvUtE = "ZQroxQvUtE",
ljnZdIytNL = "ljnZdIytNL",
OzQrEmOSkb = "OzQrEmOSkb",
pmvtjWLkHZ = "pmvtjWLkHZ",
uMXttkErPM = "uMXttkErPM",
etIFqBXfet = "etIFqBXfet",
IDyVAekiNt = "IDyVAekiNt",
PrQqRAVhvv = "PrQqRAVhvv",
bgrYgeTGLw = "bgrYgeTGLw",
RIjroDuwUh = "RIjroDuwUh",
wxWmkPmkuj = "wxWmkPmkuj",
vwORtpDGBx = "vwORtpDGBx",
WMvuNmBlQF = "WMvuNmBlQF",
HHqTRrTzNd = "HHqTRrTzNd",
XroGWsCCHL = "XroGWsCCHL",
bWsOUaLNoO = "bWsOUaLNoO",
aMzkKmkmww = "aMzkKmkmww",
rmvLbNieUu = "rmvLbNieUu",
yNwLdmtBvx = "yNwLdmtBvx",
nwzICWmndY = "nwzICWmndY",
ETiLbrYcbi = "ETiLbrYcbi",
pfSmsDkUFd = "pfSmsDkUFd",
lLHAXppWDO = "lLHAXppWDO",
aVEuzlBfuN = "aVEuzlBfuN",
WnFSbTMdAj = "WnFSbTMdAj",
XeMjbRDjwJ = "XeMjbRDjwJ",
tgCguuWOYW = "tgCguuWOYW",
rehIeVettg = "rehIeVettg",
vUIdjoUmlz = "vUIdjoUmlz",
SCqWAjgKtz = "SCqWAjgKtz",
QAhFGRclDG = "QAhFGRclDG",
EWBdyUddYk = "EWBdyUddYk",
XArDBARpft = "XArDBARpft",
jXLEzuuFLj = "jXLEzuuFLj",
giHfpSjbdy = "giHfpSjbdy",
CNwWXURPzl = "CNwWXURPzl",
uuFmBiBXBH = "uuFmBiBXBH",
nnaXbDJbar = "nnaXbDJbar",
tjFWTtFnys = "tjFWTtFnys",
IEPADDkeus = "IEPADDkeus",
appzFHAguI = "appzFHAguI",
qdFDCRaotS = "qdFDCRaotS",
QuNVFwrEjv = "QuNVFwrEjv",
gHlgouXaPJ = "gHlgouXaPJ",
ceUCdPAHPK = "ceUCdPAHPK",
DiBjQZEAjP = "DiBjQZEAjP",
NkPMEteyCG = "NkPMEteyCG",
dFtzLnmkFe = "dFtzLnmkFe",
DvsqSZuKzM = "DvsqSZuKzM",
tDleyOerYr = "tDleyOerYr",
TxxIbNrupG = "TxxIbNrupG",
bKooYrpMaO = "bKooYrpMaO",
TKzLNkuoVe = "TKzLNkuoVe",
StmGrORxiU = "StmGrORxiU",
ldoJbsPiXi = "ldoJbsPiXi",
GukOusobRq = "GukOusobRq",
LllKrShXiL = "LllKrShXiL",
epejmjUvhb = "epejmjUvhb",
ytyIbnadAr = "ytyIbnadAr",
NqeJiMwqnw = "NqeJiMwqnw",
vpshJtzZKG = "vpshJtzZKG",
AusvFRaeEG = "AusvFRaeEG",
jqoCTbtlKU = "jqoCTbtlKU",
QOZFIfrCWN = "QOZFIfrCWN",
WtkuKmrNhD = "WtkuKmrNhD",
tusycMXqDx = "tusycMXqDx",
GYFQunBTuf = "GYFQunBTuf",
OtWRIrIMFW = "OtWRIrIMFW",
SidjlWuHuK = "SidjlWuHuK",
LEZKxHYsIH = "LEZKxHYsIH",
IRLuTIEnrr = "IRLuTIEnrr",
FzXgIreBex = "FzXgIreBex",
jtppvDwrZS = "jtppvDwrZS",
JBLlvBZDRp = "JBLlvBZDRp",
uhraDtsrde = "uhraDtsrde",
SFRMqQfWdV = "SFRMqQfWdV",
qalhweuKFH = "qalhweuKFH",
ueirdOppbY = "ueirdOppbY",
bzntQtQXfn = "bzntQtQXfn",
rjwqKBuInF = "rjwqKBuInF",
uVhKvemGrE = "uVhKvemGrE",
TibxAENTeP = "TibxAENTeP",
uPVVtEGFQx = "uPVVtEGFQx",
vkeiAjWlLt = "vkeiAjWlLt",
ARneUrcIDh = "ARneUrcIDh",
dbpPVyiinF = "dbpPVyiinF",
eZgeCfwucF = "eZgeCfwucF",
OIhVumDFty = "OIhVumDFty",
ypkichviRp = "ypkichviRp",
QXZNyANYog = "QXZNyANYog",
SaHcEUrALP = "SaHcEUrALP",
gHAukNniWr = "gHAukNniWr",
NHgAagqrQH = "NHgAagqrQH",
omBmuxzDab = "omBmuxzDab",
JGPdeioylv = "JGPdeioylv",
LRlzOqGsvM = "LRlzOqGsvM",
IXwkHQZmvw = "IXwkHQZmvw",
pRxdVbHenA = "pRxdVbHenA",
iCYMWXJIdD = "iCYMWXJIdD",
SxJTfXXyuR = "SxJTfXXyuR",
MAxQdYupRg = "MAxQdYupRg",
zoeEUwtCgT = "zoeEUwtCgT",
DGFuTSzmgT = "DGFuTSzmgT",
OGZIstglcY = "OGZIstglcY",
lOWagnCWHx = "lOWagnCWHx",
TiAosWZntY = "TiAosWZntY",
DOanHgaUoN = "DOanHgaUoN",
weNarsJpAq = "weNarsJpAq",
TcstXpYbpM = "TcstXpYbpM",
BFsKbNrown = "BFsKbNrown",
BSoVzMNIyY = "BSoVzMNIyY",
KueFRgTyyp = "KueFRgTyyp",
yRIsLEPVcb = "yRIsLEPVcb",
tjtyCbiCht = "tjtyCbiCht",
RXFmDqXthr = "RXFmDqXthr",
gGBFEKYeKv = "gGBFEKYeKv",
neMuOeqeFC = "neMuOeqeFC",
MkeYVTYOPv = "MkeYVTYOPv",
JOCkChAqjr = "JOCkChAqjr",
rDUeXNzDim = "rDUeXNzDim",
CVbwerRVFs = "CVbwerRVFs",
VeHKYyFBNp = "VeHKYyFBNp",
hJUFFLCTOr = "hJUFFLCTOr",
xxKBhRNKJZ = "xxKBhRNKJZ",
BZtAJDeeej = "BZtAJDeeej",
nTYQDltUJB = "nTYQDltUJB",
IABNxVDZGd = "IABNxVDZGd",
IAvgypJyik = "IAvgypJyik",
WMnRiQJmnk = "WMnRiQJmnk",
XeWMXzxfeF = "XeWMXzxfeF",
qwsyzKbIxT = "qwsyzKbIxT",
xYSOedwxTR = "xYSOedwxTR",
vuiBtqrhXc = "vuiBtqrhXc",
iFXSOxVEvo = "iFXSOxVEvo",
ZxWDiurJqS = "ZxWDiurJqS",
UErBYePeBa = "UErBYePeBa",
wiMdfNsosQ = "wiMdfNsosQ",
OGGNnRSqTU = "OGGNnRSqTU",
qtJydTFOkk = "qtJydTFOkk",
umpzDRxfry = "umpzDRxfry",
ylrjMBLgdu = "ylrjMBLgdu",
GkxHqAdIND = "GkxHqAdIND",
vJgTBUdOYP = "vJgTBUdOYP",
caxGUBnelJ = "caxGUBnelJ",
XoliErLHWZ = "XoliErLHWZ",
NseaUBuJZS = "NseaUBuJZS",
CicRjkxTKk = "CicRjkxTKk",
sJhtzBfkyr = "sJhtzBfkyr",
PoNcosEPwZ = "PoNcosEPwZ",
yNBazPyxLR = "yNBazPyxLR",
tXEXlMaGPN = "tXEXlMaGPN",
UURCXrnvlt = "UURCXrnvlt",
eTzrrgMeYL = "eTzrrgMeYL",
steLbFEGjt = "steLbFEGjt",
QkLrehPuPs = "QkLrehPuPs",
xuKhgeEtDt = "xuKhgeEtDt",
VwRuNIVFae = "VwRuNIVFae",
pYCvbzLdNR = "pYCvbzLdNR",
QyJgwqqwEJ = "QyJgwqqwEJ",
htimnRXLGB = "htimnRXLGB",
GcqWOpktXN = "GcqWOpktXN",
FOtXSfhMXy = "FOtXSfhMXy",
XibCLINfsc = "XibCLINfsc",
yPbCvFNIBP = "yPbCvFNIBP",
MrwURVUGua = "MrwURVUGua",
tltLtZzzue = "tltLtZzzue",
eXgEplglTL = "eXgEplglTL",
FeBqZaWzdZ = "FeBqZaWzdZ",
bGTrNhxeTe = "bGTrNhxeTe",
FoSuSpijWe = "FoSuSpijWe",
hhuLpxSgsi = "hhuLpxSgsi",
jyhenCSxBu = "jyhenCSxBu",
ypwxvtgrek = "ypwxvtgrek",
nsiHXEPStG = "nsiHXEPStG",
uwCweuCOMX = "uwCweuCOMX",
GKUNpIJrve = "GKUNpIJrve",
PpjWanuTsD = "PpjWanuTsD",
JHbmoIxAsq = "JHbmoIxAsq",
QVfMuuqDPj = "QVfMuuqDPj",
bvurYcInOF = "bvurYcInOF",
CcplzfKhEQ = "CcplzfKhEQ",
eYWQIllvou = "eYWQIllvou",
ieusnEwnIw = "ieusnEwnIw",
LKWnZOQdaB = "LKWnZOQdaB",
rkmsVtQUqg = "rkmsVtQUqg",
RVuKVyOCPp = "RVuKVyOCPp",
ZxXMYyteJh = "ZxXMYyteJh",
wwkdFGoZyo = "wwkdFGoZyo",
rzwZIdyGrr = "rzwZIdyGrr",
DAQofUPgMr = "DAQofUPgMr",
FYOPyMvQnm = "FYOPyMvQnm",
nCyaHlTSeL = "nCyaHlTSeL",
QPgfIjPwrx = "QPgfIjPwrx",
CoUunoYYPf = "CoUunoYYPf",
rTMYplVtyu = "rTMYplVtyu",
JCQGhLfnLE = "JCQGhLfnLE",
UkSjItcqPN = "UkSjItcqPN",
CNmDfnbydR = "CNmDfnbydR",
zWIqGywalC = "zWIqGywalC",
CixfMmKxIe = "CixfMmKxIe",
jyhOEGwDZd = "jyhOEGwDZd",
WFIRkUhLPm = "WFIRkUhLPm",
TewChLrBCy = "TewChLrBCy",
RpJUktuFpP = "RpJUktuFpP",
zdwEGDdtSy = "zdwEGDdtSy",
RDUqeAVIUr = "RDUqeAVIUr",
tBeFjUJBVe = "tBeFjUJBVe",
ZstkpZhmBy = "ZstkpZhmBy",
wYQwijjQCQ = "wYQwijjQCQ",
huQFPZbgLm = "huQFPZbgLm",
itrbGYpOkO = "itrbGYpOkO",
auFrrWkEDA = "auFrrWkEDA",
ZykELWqOeL = "ZykELWqOeL",
UBdRNFROBP = "UBdRNFROBP",
goWjNlKnkh = "goWjNlKnkh",
xbHCpyGuVk = "xbHCpyGuVk",
CEbinezSHq = "CEbinezSHq",
IorDBJdMbF = "IorDBJdMbF",
KKMijnYDOO = "KKMijnYDOO",
NtUNVYtuSG = "NtUNVYtuSG",
eHAoOIXuEv = "eHAoOIXuEv",
EyqtgXfUFu = "EyqtgXfUFu",
INtBTrVPeE = "INtBTrVPeE",
pefKFSzzer = "pefKFSzzer",
sQLnxhYMMO = "sQLnxhYMMO",
ECsMDKFzvi = "ECsMDKFzvi",
HQcdleQfve = "HQcdleQfve",
UUGOlNPDGT = "UUGOlNPDGT",
NwkblLJeke = "NwkblLJeke",
teLUHJrtDR = "teLUHJrtDR",
rLunUkElNe = "rLunUkElNe",
nDcKjpgAAa = "nDcKjpgAAa",
tDSvqLfAPV = "tDSvqLfAPV",
ErFRQqTVQN = "ErFRQqTVQN",
OArtrgsrTp = "OArtrgsrTp",
ebgoxKIWHU = "ebgoxKIWHU",
PkFLSzyTIE = "PkFLSzyTIE",
obWwsouYhl = "obWwsouYhl",
StzgvHjiYr = "StzgvHjiYr",
tnFVQbiMEA = "tnFVQbiMEA",
pHnwfKfYvA = "pHnwfKfYvA",
yRiHrelsEJ = "yRiHrelsEJ",
yDDeEHcHGv = "yDDeEHcHGv",
syPnbQoiQu = "syPnbQoiQu",
NAgRsxWuXd = "NAgRsxWuXd",
EuHLzlCeTf = "EuHLzlCeTf",
ofvYavHOaB = "ofvYavHOaB",
RnVCmMgGoo = "RnVCmMgGoo",
wGeRdNZdIT = "wGeRdNZdIT",
pttFNWezuf = "pttFNWezuf",
iZzuToEYUL = "iZzuToEYUL",
kduzqzUrQL = "kduzqzUrQL",
zmebeLQHHs = "zmebeLQHHs",
qGkrPqRzNI = "qGkrPqRzNI",
vPEVkGzeMT = "vPEVkGzeMT",
mZZXZwqShZ = "mZZXZwqShZ",
nYBjJLJRVD = "nYBjJLJRVD",
YCBOeXOefg = "YCBOeXOefg",
SyRtwLYurp = "SyRtwLYurp",
UdsXNtUtiv = "UdsXNtUtiv",
jBqvPpUDDP = "jBqvPpUDDP",
SkYZfSpezF = "SkYZfSpezF",
LjLjAIIouV = "LjLjAIIouV",
rwIYGxKDwX = "rwIYGxKDwX",
glmbtkJWhw = "glmbtkJWhw",
FYmfHIBlXe = "FYmfHIBlXe",
lXAcYDKxVP = "lXAcYDKxVP",
MeywfMuFUf = "MeywfMuFUf",
mpWeNmGdqJ = "mpWeNmGdqJ",
ECPtuHtjOW = "ECPtuHtjOW",
tIrKaYYxWh = "tIrKaYYxWh",
tSDkLpBvPZ = "tSDkLpBvPZ",
qpjnmUSdvv = "qpjnmUSdvv",
oRKwjhEscD = "oRKwjhEscD",
DifltBhPQI = "DifltBhPQI",
IJycMueZQl = "IJycMueZQl",
ZOJvEtroKu = "ZOJvEtroKu",
RSuZRLuEPP = "RSuZRLuEPP",
jtyzTttVrn = "jtyzTttVrn",
OwFvLhOSNk = "OwFvLhOSNk",
CNdJCptunJ = "CNdJCptunJ",
GiiZidkizf = "GiiZidkizf",
RNlzoOOkQL = "RNlzoOOkQL",
TzZBmYMWQU = "TzZBmYMWQU",
VmnspsrxMq = "VmnspsrxMq",
QXsBwtOvgZ = "QXsBwtOvgZ",
gYHoWVmyuW = "gYHoWVmyuW",
RytoKXaBWV = "RytoKXaBWV",
hbXIwzadah = "hbXIwzadah",
TVOtfsJzaa = "TVOtfsJzaa",
rkuQphNEyr = "rkuQphNEyr",
NRCmyiLYwE = "NRCmyiLYwE",
DEVWzRIvwy = "DEVWzRIvwy",
hAhtpdEMKp = "hAhtpdEMKp",
QDmnEvpocW = "QDmnEvpocW",
nzpbpfbaWX = "nzpbpfbaWX",
MgwOWUGduU = "MgwOWUGduU",
YcuVZLrUzH = "YcuVZLrUzH",
wqGOEwyYJX = "wqGOEwyYJX",
MCHkvVfSmf = "MCHkvVfSmf",
IlWQmnpGQt = "IlWQmnpGQt",
ncytRcJMjw = "ncytRcJMjw",
krAmtgaxGp = "krAmtgaxGp",
ZHkBDaqjvE = "ZHkBDaqjvE",
SjrwakSBPA = "SjrwakSBPA",
xfMeEUPaZe = "xfMeEUPaZe",
rJpxTNXLYa = "rJpxTNXLYa",
wEYOmhKRYe = "wEYOmhKRYe",
YgYHjVVxVl = "YgYHjVVxVl",
BMkUzLcMrr = "BMkUzLcMrr",
lRnNdoSCRj = "lRnNdoSCRj",
RmLalUbgnz = "RmLalUbgnz",
QpaoWMQzau = "QpaoWMQzau",
EvOwCxuycZ = "EvOwCxuycZ",
CteGZiZuEr = "CteGZiZuEr",
jkgZEWvCdc = "jkgZEWvCdc",
ugMtbMZODa = "ugMtbMZODa",
pYKBdZkcPA = "pYKBdZkcPA",
RuWacmRfxM = "RuWacmRfxM",
wGypApxTjq = "wGypApxTjq",
gbQtUBPdrD = "gbQtUBPdrD",
PaKqfBgFRF = "PaKqfBgFRF",
KVmfrXYKVF = "KVmfrXYKVF",
OJYVdoeeyT = "OJYVdoeeyT",
YJsprrJjsz = "YJsprrJjsz",
nXTlSPJHtd = "nXTlSPJHtd",
OexCxbZNvM = "OexCxbZNvM",
ohGPttzuVw = "ohGPttzuVw",
HLEiXkIstB = "HLEiXkIstB",
PPaMvdxpFw = "PPaMvdxpFw",
xACAGPjgiM = "xACAGPjgiM",
UeqkosLwKr = "UeqkosLwKr",
uSffLTgSiv = "uSffLTgSiv",
zFSDHPNYoo = "zFSDHPNYoo",
lYzgreMTLG = "lYzgreMTLG",
brugsDmjmc = "brugsDmjmc",
BaIwmorTuk = "BaIwmorTuk",
DtYswEqRCt = "DtYswEqRCt",
SYopeugmuC = "SYopeugmuC",
nrosxeAHVA = "nrosxeAHVA",
eLuBwuyzey = "eLuBwuyzey",
oHuWxAlmRo = "oHuWxAlmRo",
MKADNVDLMi = "MKADNVDLMi",
oYEEsRsJel = "oYEEsRsJel",
yZRCzcEmrq = "yZRCzcEmrq",
fdegChwjzM = "fdegChwjzM",
uSieMbtyZe = "uSieMbtyZe",
bMMGOIxHPu = "bMMGOIxHPu",
tuLqgBGabe = "tuLqgBGabe",
dutinuaxzH = "dutinuaxzH",
cuCnDaNyGL = "cuCnDaNyGL",
wcdtEiJWlN = "wcdtEiJWlN",
zyPvBEEyvi = "zyPvBEEyvi",
mWlBrPiarI = "mWlBrPiarI",
PqgdZZTsnt = "PqgdZZTsnt",
AjGJguOqly = "AjGJguOqly",
EIXgUnBugu = "EIXgUnBugu",
ndWwfnFOMt = "ndWwfnFOMt",
NnPXLMfSYa = "NnPXLMfSYa",
ezlFMAgJHF = "ezlFMAgJHF",
FOwvqFzJbR = "FOwvqFzJbR",
gEFqCdkfyJ = "gEFqCdkfyJ",
QnjleSuUgb = "QnjleSuUgb",
iCKBXGWlOO = "iCKBXGWlOO",
WlyeeRbHex = "WlyeeRbHex",
VPSaakAELz = "VPSaakAELz",
vQQPpjnMxg = "vQQPpjnMxg",
oXdVPOdurb = "oXdVPOdurb",
XZYuNeetFv = "XZYuNeetFv",
BCWdhQLzOb = "BCWdhQLzOb",
ZxnwrMjjWM = "ZxnwrMjjWM",
icsuYDjajC = "icsuYDjajC",
tNHQplamIc = "tNHQplamIc",
rgtonbhMro = "rgtonbhMro",
wCYhABRuFD = "wCYhABRuFD",
dHerQdqWLO = "dHerQdqWLO",
HzKrxxnrTW = "HzKrxxnrTW",
VytjyDVRSj = "VytjyDVRSj",
ietqoZjeyu = "ietqoZjeyu",
TWfiOIfkMR = "TWfiOIfkMR",
qcKFVLIqdT = "qcKFVLIqdT",
VqsljWrVjB = "VqsljWrVjB",
SZYNiiEmMZ = "SZYNiiEmMZ",
MQKQtvtnqo = "MQKQtvtnqo",
QRGSnqZprQ = "QRGSnqZprQ",
MISRAdrvXm = "MISRAdrvXm",
FyurDyTjRV = "FyurDyTjRV",
kBPWJXXfuc = "kBPWJXXfuc",
SgzaOfGcZg = "SgzaOfGcZg",
MKdbcKZIbF = "MKdbcKZIbF",
nfXJOveucx = "nfXJOveucx",
huERDYrsST = "huERDYrsST",
lfuOtxTUPG = "lfuOtxTUPG",
WbUziHMmWq = "WbUziHMmWq",
jjnAmDiGEn = "jjnAmDiGEn",
oVitvOmcrC = "oVitvOmcrC",
eFqWQKkXTa = "eFqWQKkXTa",
rKaGCyBxGN = "rKaGCyBxGN",
EoDAlrJiSA = "EoDAlrJiSA",
mZxYGWXmQO = "mZxYGWXmQO",
VLoAHmcouz = "VLoAHmcouz",
KpNBrQGUrC = "KpNBrQGUrC",
dYPfdFEDxc = "dYPfdFEDxc",
XhoymoThqf = "XhoymoThqf",
MCedWueKKP = "MCedWueKKP",
ZujBbhOEkr = "ZujBbhOEkr",
qLkVOdtnIK = "qLkVOdtnIK",
HnJHkzKzYO = "HnJHkzKzYO",
pSrRUHSBur = "pSrRUHSBur",
iDeirPpuDs = "iDeirPpuDs",
teeyVSuHDU = "teeyVSuHDU",
RpQDAatxlz = "RpQDAatxlz",
tlcAgdtaCd = "tlcAgdtaCd",
CFzrbWwYGD = "CFzrbWwYGD",
ajCAGCGbVu = "ajCAGCGbVu",
dOJYqBKxdg = "dOJYqBKxdg",
XlJFQfIRQQ = "XlJFQfIRQQ",
kgBefLyvdm = "kgBefLyvdm",
BfRibtievE = "BfRibtievE",
RgDdXLaAEv = "RgDdXLaAEv",
nJMqvqxgcb = "nJMqvqxgcb",
fVLuFfKGBD = "fVLuFfKGBD",
vybtaGTHZO = "vybtaGTHZO",
MttdUtxZbO = "MttdUtxZbO",
YRNqsVPozS = "YRNqsVPozS",
BytIOdBHsB = "BytIOdBHsB",
cFDBqqrrxN = "cFDBqqrrxN",
DdtYjrRvMT = "DdtYjrRvMT",
avruQeOnrp = "avruQeOnrp",
JtZppHKcAI = "JtZppHKcAI",
sVENlbhUhh = "sVENlbhUhh",
peCiANWwDt = "peCiANWwDt",
PgWTcmeSQt = "PgWTcmeSQt",
DdApqwCQNe = "DdApqwCQNe",
kKzoAguMkY = "kKzoAguMkY",
FzucwbRKKc = "FzucwbRKKc",
eQEacfDCZl = "eQEacfDCZl",
lKBPAVTiyu = "lKBPAVTiyu",
DtmGDWtRmS = "DtmGDWtRmS",
GtIrEFwAwP = "GtIrEFwAwP",
tVgDtsfCzX = "tVgDtsfCzX",
nfHlzQUZzI = "nfHlzQUZzI",
tOfVnGuhec = "tOfVnGuhec",
QqfaAJErpE = "QqfaAJErpE",
VyOyEPaGlq = "VyOyEPaGlq",
OrrMwHWZvI = "OrrMwHWZvI",
mBxtlAPZfu = "mBxtlAPZfu",
ZTjilucXMW = "ZTjilucXMW",
EFrQLnarTL = "EFrQLnarTL",
WrYitxoJju = "WrYitxoJju",
pyheJeOhit = "pyheJeOhit",
nZRHwGnhxm = "nZRHwGnhxm",
HFOtfNwuXs = "HFOtfNwuXs",
XmtRBWDUWB = "XmtRBWDUWB",
eXWuRouhjt = "eXWuRouhjt",
ycsbpuhqRe = "ycsbpuhqRe",
RYeWXzgDdE = "RYeWXzgDdE",
OrTKkmkEhg = "OrTKkmkEhg",
vEEvEoJjQG = "vEEvEoJjQG",
ZUOpZtUmrJ = "ZUOpZtUmrJ",
nFRdYtYKPa = "nFRdYtYKPa",
ToucKcxonG = "ToucKcxonG",
PftfbSdFeX = "PftfbSdFeX",
tNmHtorNYU = "tNmHtorNYU",
gNfFdFVVFA = "gNfFdFVVFA",
QyQYXrqOQU = "QyQYXrqOQU",
RkCLWYufea = "RkCLWYufea",
anlIvtkVRR = "anlIvtkVRR",
tnsbsGxzkr = "tnsbsGxzkr",
WXFIrAysvJ = "WXFIrAysvJ",
qOoFvLPMbe = "qOoFvLPMbe",
VANVrkfJdI = "VANVrkfJdI",
FjmeJbTYcm = "FjmeJbTYcm",
uyCrqDBFLw = "uyCrqDBFLw",
yDSMxSKuKn = "yDSMxSKuKn",
tmuHiiNhie = "tmuHiiNhie",
aQPSIgCjbo = "aQPSIgCjbo",
PullwerArl = "PullwerArl",
cuuRDLSGKe = "cuuRDLSGKe",
NZuTZIPOaP = "NZuTZIPOaP",
lqWaJOpVvE = "lqWaJOpVvE",
NZGoibqmNH = "NZGoibqmNH",
AquSAaLKnl = "AquSAaLKnl",
LuMURDOVVQ = "LuMURDOVVQ",
tPefTRZYvA = "tPefTRZYvA",
euqyzttRhW = "euqyzttRhW",
xrjYYyZJcO = "xrjYYyZJcO",
IzdXmerqPQ = "IzdXmerqPQ",
fgouDslTlF = "fgouDslTlF",
bTSBLGjJuy = "bTSBLGjJuy",
IkuJYpquEQ = "IkuJYpquEQ",
ZzqOEJbvLi = "ZzqOEJbvLi",
RsADUjPtJl = "RsADUjPtJl",
sUbePtzlCi = "sUbePtzlCi",
sOzTOsKSiY = "sOzTOsKSiY",
fJWOZgNwnA = "fJWOZgNwnA",
arBmAISLwe = "arBmAISLwe",
LivecduEGZ = "LivecduEGZ",
rtbqhIrXKQ = "rtbqhIrXKQ",
IeNSgkVBsb = "IeNSgkVBsb",
crIUcyIgsD = "crIUcyIgsD",
GHlWCnDNjV = "GHlWCnDNjV",
zrdmatBtla = "zrdmatBtla",
huICsPKWtj = "huICsPKWtj",
fptXEruZOE = "fptXEruZOE",
bDZoJIDVuc = "bDZoJIDVuc",
ugNJwtUyZY = "ugNJwtUyZY",
jolnaeMfCu = "jolnaeMfCu",
IDOwkJQuvB = "IDOwkJQuvB",
ieBGrjemSN = "ieBGrjemSN",
HrimedtCfO = "HrimedtCfO",
PjJcwhgRCO = "PjJcwhgRCO",
itcruZaHhr = "itcruZaHhr",
zWpHdSKXeX = "zWpHdSKXeX",
WYBUlWtorX = "WYBUlWtorX",
DdDlnYBAXc = "DdDlnYBAXc",
PYoyLouNEh = "PYoyLouNEh",
XCtEomZVTL = "XCtEomZVTL",
hpkPQJGeAa = "hpkPQJGeAa",
IyalNRtWKt = "IyalNRtWKt",
QxehNbcjcr = "QxehNbcjcr",
kgSrseswhm = "kgSrseswhm",
dtupUqesvV = "dtupUqesvV",
TUKlbQDOCF = "TUKlbQDOCF",
qTkHQkLjnd = "qTkHQkLjnd",
FaLuFrfmue = "FaLuFrfmue",
fEOSomBFCs = "fEOSomBFCs",
LUfwXuTpEo = "LUfwXuTpEo",
MeGNBquPAe = "MeGNBquPAe",
ZuUuncmtVs = "ZuUuncmtVs",
AFKtFzbGVS = "AFKtFzbGVS",
wrVZDuThhX = "wrVZDuThhX",
pkMTZiqmaH = "pkMTZiqmaH",
CUedMYsnyA = "CUedMYsnyA",
gvNPtzFsJa = "gvNPtzFsJa",
rLebEDjizG = "rLebEDjizG",
DeqrulsYCx = "DeqrulsYCx",
WHGNxduOjb = "WHGNxduOjb",
vkibGhhFZI = "vkibGhhFZI",
GYeqAnLHew = "GYeqAnLHew",
ggdxFXQCye = "ggdxFXQCye",
sWtEuSkbwm = "sWtEuSkbwm",
ZZfSIpAqTB = "ZZfSIpAqTB",
cKqczAkrrs = "cKqczAkrrs",
RtrprCWvTr = "RtrprCWvTr",
RWxbygieap = "RWxbygieap",
feuyJtxuGW = "feuyJtxuGW",
FrrOVlvArA = "FrrOVlvArA",
tBzXrtuTjk = "tBzXrtuTjk",
TguPyeemsV = "TguPyeemsV",
naNyhXHCWv = "naNyhXHCWv",
RKaKxZoatC = "RKaKxZoatC",
LqnxABozCp = "LqnxABozCp",
upjLUDafit = "upjLUDafit",
eRthHwhyRJ = "eRthHwhyRJ",
KVEqnETkme = "KVEqnETkme",
yTcUrrfcrO = "yTcUrrfcrO",
HbGixKmKDc = "HbGixKmKDc",
hpfhouUuxe = "hpfhouUuxe",
lBnDFcNmOq = "lBnDFcNmOq",
YZvvpsGolU = "YZvvpsGolU",
iQjEKCzZTD = "iQjEKCzZTD",
qSuDDbUXef = "qSuDDbUXef",
xFvExGuDIe = "xFvExGuDIe",
vwklMlzIyx = "vwklMlzIyx",
YsfXSfItdV = "YsfXSfItdV",
IDcQMvIeZT = "IDcQMvIeZT",
UnKuLrlMtc = "UnKuLrlMtc",
ffZIUTTqLx = "ffZIUTTqLx",
aOJlNmTgeh = "aOJlNmTgeh",
XuoOrczTFl = "XuoOrczTFl",
FrcyigQItu = "FrcyigQItu",
UZmSxdGpgR = "UZmSxdGpgR",
jeUvYjPyaO = "jeUvYjPyaO",
tcapMzMjPe = "tcapMzMjPe",
FSuBxwxXqo = "FSuBxwxXqo",
XJbvMSFyqZ = "XJbvMSFyqZ",
gDapBkwUKI = "gDapBkwUKI",
vtaHPfssyJ = "vtaHPfssyJ",
vtqYvwGsgu = "vtqYvwGsgu",
judWuTRYOH = "judWuTRYOH",
fXPrdEgPQy = "fXPrdEgPQy",
kAoSqYWODJ = "kAoSqYWODJ",
UwPPPXUBvE = "UwPPPXUBvE",
EoNFwFAkrX = "EoNFwFAkrX",
PmurSqNBRH = "PmurSqNBRH",
SxHpntFiNq = "SxHpntFiNq",
QkPcHLXqQy = "QkPcHLXqQy",
ebpzqQaUEr = "ebpzqQaUEr",
DtYutAuqae = "DtYutAuqae",
ulHCfkDlJU = "ulHCfkDlJU",
XystuvtqIv = "XystuvtqIv",
reAEhVYKVz = "reAEhVYKVz",
slaqKUSRMn = "slaqKUSRMn",
gtySVvStVr = "gtySVvStVr",
nXVsEFZLMt = "nXVsEFZLMt",
LbteXGgQyr = "LbteXGgQyr",
WcjPkHlMKq = "WcjPkHlMKq",
sgaSwNKkpl = "sgaSwNKkpl",
bHYuiKYDng = "bHYuiKYDng",
FkVzYGtpuP = "FkVzYGtpuP",
MgFMVoFjKl = "MgFMVoFjKl",
xwdsPqCwPk = "xwdsPqCwPk",
LYOOiuorvs = "LYOOiuorvs",
tDFnzkTgzr = "tDFnzkTgzr",
NuSOVjCGYt = "NuSOVjCGYt",
tDqbVOQZZA = "tDqbVOQZZA",
hIkntZjKyo = "hIkntZjKyo",
euHCrDINVc = "euHCrDINVc",
cCdDuWHSxw = "cCdDuWHSxw",
rUZttZzTGZ = "rUZttZzTGZ",
YDYxsxRplu = "YDYxsxRplu",
riPBUojgNf = "riPBUojgNf",
rdMyDVIoEt = "rdMyDVIoEt",
OMEXmtvhkd = "OMEXmtvhkd",
NOKsTMjISn = "NOKsTMjISn",
eceoYEroUF = "eceoYEroUF",
tHQwHKPIeR = "tHQwHKPIeR",
OdPklusVsW = "OdPklusVsW",
MenVIErgaL = "MenVIErgaL",
CyxMulFdmf = "CyxMulFdmf",
ABEazoYTmM = "ABEazoYTmM",
rZWkSIoRqm = "rZWkSIoRqm",
HpVCIecmsC = "HpVCIecmsC",
SdWxQLbGOo = "SdWxQLbGOo",
cUeHgVtlWF = "cUeHgVtlWF",
neRtNGQhmj = "neRtNGQhmj",
ZOYKxkPzeQ = "ZOYKxkPzeQ",
aeQOvmVexh = "aeQOvmVexh",
tuAdNYybXd = "tuAdNYybXd",
WxAwWPHllu = "WxAwWPHllu",
wefdjXgleW = "wefdjXgleW",
OytwgCIdtu = "OytwgCIdtu",
USmCwxIzrB = "USmCwxIzrB",
caXesrtEUd = "caXesrtEUd",
XatlhuJPhf = "XatlhuJPhf",
baLfODejSG = "baLfODejSG",
bQsfzmbwur = "bQsfzmbwur",
jVQDkzwYKR = "jVQDkzwYKR",
ufpPyeJvbw = "ufpPyeJvbw",
unoRrptySg = "unoRrptySg",
FygfNrjAiw = "FygfNrjAiw",
YFAtLytgAN = "YFAtLytgAN",
aWtYpIvjlr = "aWtYpIvjlr",
nFwLrUaALz = "nFwLrUaALz",
lUYSurcYne = "lUYSurcYne",
BmaiRubKyz = "BmaiRubKyz",
mcezbalhLT = "mcezbalhLT",
FtTReoLVUw = "FtTReoLVUw",
xefQRCkslI = "xefQRCkslI",
IeYXxMYPSp = "IeYXxMYPSp",
vAmtxmnhZe = "vAmtxmnhZe",
sUVPxbQXoJ = "sUVPxbQXoJ",
yLLikmNmBC = "yLLikmNmBC",
WWWZssbMnr = "WWWZssbMnr",
UPdErSyasw = "UPdErSyasw",
KNJTgzTNVv = "KNJTgzTNVv",
GmhrsMbrPV = "GmhrsMbrPV",
mRcOqEfsjl = "mRcOqEfsjl",
CArVGKsQtD = "CArVGKsQtD",
vuybXdGezr = "vuybXdGezr",
idxqDEtACx = "idxqDEtACx",
leXeuEvfIG = "leXeuEvfIG",
jRewIeHzXx = "jRewIeHzXx",
IxPgxrosip = "IxPgxrosip",
vMganFzslg = "vMganFzslg",
cxvQBhIsPx = "cxvQBhIsPx",
LPbgrIpzzd = "LPbgrIpzzd",
VaUrPpswve = "VaUrPpswve",
AZRFYFeuEI = "AZRFYFeuEI",
sVVMZgqMzj = "sVVMZgqMzj",
KUZijavdbW = "KUZijavdbW",
StYkUotrtO = "StYkUotrtO",
rHwtxhrcxL = "rHwtxhrcxL",
ydGiDfHjQu = "ydGiDfHjQu",
dZIGtrtppr = "dZIGtrtppr",
gSLWFysQQC = "gSLWFysQQC",
qOvUNhYZPu = "qOvUNhYZPu",
rtMMebwOmw = "rtMMebwOmw",
PyrrpTLUpM = "PyrrpTLUpM",
cqXmQbOHgL = "cqXmQbOHgL",
EXKKCgbowe = "EXKKCgbowe",
IXnFIlJFRP = "IXnFIlJFRP",
pkIEbBqQQh = "pkIEbBqQQh",
HRdwDyPZrB = "HRdwDyPZrB",
nZYwNZCvTF = "nZYwNZCvTF",
bltZqrEOSY = "bltZqrEOSY",
ZxeFoZnLbH = "ZxeFoZnLbH",
nDQHeDYnrS = "nDQHeDYnrS",
RKjgfHDrLH = "RKjgfHDrLH",
DZLzyxfjeD = "DZLzyxfjeD",
zsYzgvkXqA = "zsYzgvkXqA",
LTEUyAmuLX = "LTEUyAmuLX",
MTMsrrwbIE = "MTMsrrwbIE",
vlzluQeHOh = "vlzluQeHOh",
YLAervCeVo = "YLAervCeVo",
BGtuAwmVtz = "BGtuAwmVtz",
sHSEnkczKw = "sHSEnkczKw",
ZwaquHFuAH = "ZwaquHFuAH",
kOejZqxFlO = "kOejZqxFlO",
giJMCXdgLG = "giJMCXdgLG",
sJtmuPurry = "sJtmuPurry",
FGbJIxppYp = "FGbJIxppYp",
bnrfKNTqJO = "bnrfKNTqJO",
fERMQggHkV = "fERMQggHkV",
XpBETjcLEQ = "XpBETjcLEQ",
dZJJEnijYm = "dZJJEnijYm",
KCHfYDhdBC = "KCHfYDhdBC",
fDGtyDeqaB = "fDGtyDeqaB",
spuSCLSQhE = "spuSCLSQhE",
rsFfAlouep = "rsFfAlouep",
tkrGFTIFtr = "tkrGFTIFtr",
zTOOBeWHqj = "zTOOBeWHqj",
rGmEdfPNtE = "rGmEdfPNtE",
mtaUuuzMPz = "mtaUuuzMPz",
uQuVfdwqhQ = "uQuVfdwqhQ",
iPPZenRyHr = "iPPZenRyHr",
rlKglDBuJy = "rlKglDBuJy",
unFUkXtvWu = "unFUkXtvWu",
yqpeiKoXsj = "yqpeiKoXsj",
GpcBBPuLwu = "GpcBBPuLwu",
LVGcwPkofY = "LVGcwPkofY",
bZZnSDLAcu = "bZZnSDLAcu",
BdmnBrgbtr = "BdmnBrgbtr",
TzCotabrJf = "TzCotabrJf",
cuLAUtiKfw = "cuLAUtiKfw",
UjSQBByIPn = "UjSQBByIPn",
VOceERGtnk = "VOceERGtnk",
bsAeQWlPVd = "bsAeQWlPVd",
YteQfmFeqN = "YteQfmFeqN",
KXcsQMAvQt = "KXcsQMAvQt",
nvMhkTrvHW = "nvMhkTrvHW",
MAclljdmcz = "MAclljdmcz",
sTwTcAJweG = "sTwTcAJweG",
tuSemzSevJ = "tuSemzSevJ",
YueeyyLxMK = "YueeyyLxMK",
rOSJyaZhyt = "rOSJyaZhyt",
BqGuFZaXeI = "BqGuFZaXeI",
VLPtmXFMxm = "VLPtmXFMxm",
QsBOgNTDti = "QsBOgNTDti",
mFRNrHHaRA = "mFRNrHHaRA",
atrUddcheZ = "atrUddcheZ",
TNbzsOHkhe = "TNbzsOHkhe",
PzEcNHhcKt = "PzEcNHhcKt",
otCpHCxtlg = "otCpHCxtlg",
kYJteTNMGI = "kYJteTNMGI",
NoOWtKEoQl = "NoOWtKEoQl",
jwWHZECnry = "jwWHZECnry",
QpZWteBCEB = "QpZWteBCEB",
crMvDttVWH = "crMvDttVWH",
cSckrluYeC = "cSckrluYeC",
DpiZvucuTN = "DpiZvucuTN",
BLYBlQonfn = "BLYBlQonfn",
AlGSSeTSHw = "AlGSSeTSHw",
QcRDHuqQCZ = "QcRDHuqQCZ",
KuLEubPDyx = "KuLEubPDyx",
UgiWqQpCHc = "UgiWqQpCHc",
XicsdzTPxp = "XicsdzTPxp",
iscsbTiLwJ = "iscsbTiLwJ",
XNlsPNCQbd = "XNlsPNCQbd",
pvgBLNjucB = "pvgBLNjucB",
flEXupBiaf = "flEXupBiaf",
ZQIWayEbPU = "ZQIWayEbPU",
rWpOgFDsVa = "rWpOgFDsVa",
QRKTTRErQe = "QRKTTRErQe",
ZhlPrgaNFe = "ZhlPrgaNFe",
MowprjfoxK = "MowprjfoxK",
ortuPqUvSt = "ortuPqUvSt",
FACLuQywQu = "FACLuQywQu",
XNvZjKaeWk = "XNvZjKaeWk",
lpFCIPXTRC = "lpFCIPXTRC",
DgrsuKhWcj = "DgrsuKhWcj",
rOMcQUerrn = "rOMcQUerrn",
OfVaLqKMkv = "OfVaLqKMkv",
izyngxjIrt = "izyngxjIrt",
nvIfrCpURV = "nvIfrCpURV",
kuOAWGGXMQ = "kuOAWGGXMQ",
OollGGtunH = "OollGGtunH",
fMbxMYFeTQ = "fMbxMYFeTQ",
KQXwUoyxub = "KQXwUoyxub",
hCpCUmMXEr = "hCpCUmMXEr",
nZaSUBatBE = "nZaSUBatBE",
yhiVYiOUvY = "yhiVYiOUvY",
alcFadoikr = "alcFadoikr",
MeZSrZNXqp = "MeZSrZNXqp",
WphByzWCSl = "WphByzWCSl",
TPBKJHqgZK = "TPBKJHqgZK",
ljdbqEfmep = "ljdbqEfmep",
lWVreiauww = "lWVreiauww",
uyvSbzHLlP = "uyvSbzHLlP",
qiKHGOUkTu = "qiKHGOUkTu",
tTtuFdwuGK = "tTtuFdwuGK",
KaviEheurV = "KaviEheurV",
UCroMzVnaB = "UCroMzVnaB",
LdSWxyPSvk = "LdSWxyPSvk",
UbTuXKwlbb = "UbTuXKwlbb",
IiQHbSUBFL = "IiQHbSUBFL",
MrCEeNVXBt = "MrCEeNVXBt",
OdemqrdpYH = "OdemqrdpYH",
wrcUQFXkCW = "wrcUQFXkCW",
wWNpUGSeke = "wWNpUGSeke",
WUsPsAkcbh = "WUsPsAkcbh",
plxHjcBirW = "plxHjcBirW",
NxqHJbsxEr = "NxqHJbsxEr",
EHQzEoERXi = "EHQzEoERXi",
uRxwoQWdWv = "uRxwoQWdWv",
EcEJKCPLUB = "EcEJKCPLUB",
kAfuCUWciV = "kAfuCUWciV",
XDbWmKkEoY = "XDbWmKkEoY",
wYQYlQURST = "wYQYlQURST",
rOGnYsrzEa = "rOGnYsrzEa",
pfezeadGEi = "pfezeadGEi",
uILcwGiOgR = "uILcwGiOgR",
kMskDUiziK = "kMskDUiziK",
CeIylPTnni = "CeIylPTnni",
ErITaurupP = "ErITaurupP",
AgqSeqDRRr = "AgqSeqDRRr",
yqxyKOsDUS = "yqxyKOsDUS",
kCJtWWunPQ = "kCJtWWunPQ",
rDOtdMQEQD = "rDOtdMQEQD",
aqgruiQHuf = "aqgruiQHuf",
DitZwpuxCZ = "DitZwpuxCZ",
QtLkDXFSvK = "QtLkDXFSvK",
OSWcKcQfnR = "OSWcKcQfnR",
lqpICIaYYm = "lqpICIaYYm",
QwquoKScuK = "QwquoKScuK",
OzZfvdtocZ = "OzZfvdtocZ",
YGycJqdmUD = "YGycJqdmUD",
wItTQthThZ = "wItTQthThZ",
DFpQLgqJSi = "DFpQLgqJSi",
EusJZRfOeL = "EusJZRfOeL",
euBIoBLpaG = "euBIoBLpaG",
iWufiGEeDH = "iWufiGEeDH",
ioLPmkmdlq = "ioLPmkmdlq",
MLiBegEwto = "MLiBegEwto",
roHQUyPYhq = "roHQUyPYhq",
kqIoSqeDXp = "kqIoSqeDXp",
ebIfFGfOhU = "ebIfFGfOhU",
zeOtahfFgn = "zeOtahfFgn",
ricOXYvePV = "ricOXYvePV",
dMuxcHktFx = "dMuxcHktFx",
AiiYsuiHnK = "AiiYsuiHnK",
wOhXTZzvRn = "wOhXTZzvRn",
hKuePjEcVm = "hKuePjEcVm",
UZfMGXmdgP = "UZfMGXmdgP",
arbWerkhlQ = "arbWerkhlQ",
GBqheqfvIX = "GBqheqfvIX",
CblQotzQaN = "CblQotzQaN",
WKpeDEvSjj = "WKpeDEvSjj",
sXLlkeqVAW = "sXLlkeqVAW",
ohzTrPvOAB = "ohzTrPvOAB",
yxoQuanoNx = "yxoQuanoNx",
UubJmCaiMa = "UubJmCaiMa",
uaCroPCLMi = "uaCroPCLMi",
xHUZeoOSwK = "xHUZeoOSwK",
oBubltOMCE = "oBubltOMCE",
dpfuVoCver = "dpfuVoCver",
TaXJYcNvNU = "TaXJYcNvNU",
QvnEuLRntg = "QvnEuLRntg",
GyKjxAEyYZ = "GyKjxAEyYZ",
iDLDghTJBS = "iDLDghTJBS",
tgPAEzRBtu = "tgPAEzRBtu",
cTEXpQErVC = "cTEXpQErVC",
DEFGRUmYAT = "DEFGRUmYAT",
MLRKIqTyuQ = "MLRKIqTyuQ",
eqPKFZFHrE = "eqPKFZFHrE",
rTuuUNHgMt = "rTuuUNHgMt",
yVPkwKXRmj = "yVPkwKXRmj",
YfovGrRyKe = "YfovGrRyKe",
BgKnJeNHzH = "BgKnJeNHzH",
oGtiwlekMA = "oGtiwlekMA",
dsrhgMhFAA = "dsrhgMhFAA",
GkOjvbTXRB = "GkOjvbTXRB",
cZGhstpUSk = "cZGhstpUSk",
NNoaalIdtf = "NNoaalIdtf",
BuXolCLiuO = "BuXolCLiuO",
wzYCeeAXYx = "wzYCeeAXYx",
AJKUxLcakP = "AJKUxLcakP",
fcloIeXfPr = "fcloIeXfPr",
iTXNjhkwiO = "iTXNjhkwiO",
XhGshtLZxH = "XhGshtLZxH",
AKpylcfMrI = "AKpylcfMrI",
sElGlfeJoN = "sElGlfeJoN",
eiUYnRzOgC = "eiUYnRzOgC",
tntpxRetYh = "tntpxRetYh",
LdWOQrBupw = "LdWOQrBupw",
YtuimTFOeB = "YtuimTFOeB",
tWnoUGeBJp = "tWnoUGeBJp",
odOLJlgJfl = "odOLJlgJfl",
RRYumKSDSk = "RRYumKSDSk",
eJECtNLdMh = "eJECtNLdMh",
tzQXhxkXGu = "tzQXhxkXGu",
KSKCeggFtA = "KSKCeggFtA",
RCWHTgZfxw = "RCWHTgZfxw",
YLpLdVlwtG = "YLpLdVlwtG",
hnZsuOTMeT = "hnZsuOTMeT",
rokGWiofZA = "rokGWiofZA",
UQJdmYwCeu = "UQJdmYwCeu",
lXhCfPoemJ = "lXhCfPoemJ",
hOhYEEwrpE = "hOhYEEwrpE",
jxpvruNkxs = "jxpvruNkxs",
EglcUXMvva = "EglcUXMvva",
UoQeTpRsjU = "UoQeTpRsjU",
MZfPhRqeFe = "MZfPhRqeFe",
dhzupAeqsL = "dhzupAeqsL",
thBumrvLgM = "thBumrvLgM",
NsHaEEuiGv = "NsHaEEuiGv",
vnhdsWpTNz = "vnhdsWpTNz",
XeWuRgyBdE = "XeWuRgyBdE",
iviAWvyyeJ = "iviAWvyyeJ",
MspHjXKXdx = "MspHjXKXdx",
zNjJXcPHIZ = "zNjJXcPHIZ",
ebzbeeoTJR = "ebzbeeoTJR",
NHMgYyqXUM = "NHMgYyqXUM",
aFDuYLLnzD = "aFDuYLLnzD",
ycfOjincGg = "ycfOjincGg",
HjhpJQIiPm = "HjhpJQIiPm",
hqyrjAnRYu = "hqyrjAnRYu",
fLRrGfkyqs = "fLRrGfkyqs",
mmEoiWgJrB = "mmEoiWgJrB",
uMcjuTfcYt = "uMcjuTfcYt",
fKMBPHtaZr = "fKMBPHtaZr",
DBrbirIbVk = "DBrbirIbVk",
eDhMdbPmvN = "eDhMdbPmvN",
gtvSPtemBh = "gtvSPtemBh",
rMEtVNlluo = "rMEtVNlluo",
wOUNIzOJTS = "wOUNIzOJTS",
qLtLYJuvut = "qLtLYJuvut",
MemPPVxDSe = "MemPPVxDSe",
CdaMEtAkHH = "CdaMEtAkHH",
QgoToNoSUD = "QgoToNoSUD",
tUxvdXtlWu = "tUxvdXtlWu",
JwyDQAVKnC = "JwyDQAVKnC",
KkDDcIBZtG = "KkDDcIBZtG",
wXbebgxxCE = "wXbebgxxCE",
QOtAtzTmVQ = "QOtAtzTmVQ",
TPRwlgYuHD = "TPRwlgYuHD",
mTbXtOKXBD = "mTbXtOKXBD",
ZtJdcLpEXp = "ZtJdcLpEXp",
hrJlkixaAu = "hrJlkixaAu",
uBSOSvKUzW = "uBSOSvKUzW",
eiulJoeXYc = "eiulJoeXYc",
kwvruIAVul = "kwvruIAVul",
aomSmdrNtw = "aomSmdrNtw",
kuXytLfCJs = "kuXytLfCJs",
QtASrXSuEu = "QtASrXSuEu",
jdDegHhyaI = "jdDegHhyaI",
UAGuVApCug = "UAGuVApCug",
lWrHFhxBKg = "lWrHFhxBKg",
eDKVrvFnJh = "eDKVrvFnJh",
npDviuQeOC = "npDviuQeOC",
QfyiVzlAuX = "QfyiVzlAuX",
IeCBcPgUQc = "IeCBcPgUQc",
sPtDzmHups = "sPtDzmHups",
RbJyOhiTHz = "RbJyOhiTHz",
XASCAujdIW = "XASCAujdIW",
DNYauOPgBr = "DNYauOPgBr",
dmOrvpNHMr = "dmOrvpNHMr",
zQLaJMiudk = "zQLaJMiudk",
VPQPRWjVKd = "VPQPRWjVKd",
dhsdCQMTts = "dhsdCQMTts",
DElnFAFEvv = "DElnFAFEvv",
NSEaAVpClE = "NSEaAVpClE",
rXWQrvjybH = "rXWQrvjybH",
ZcXEdyzWAW = "ZcXEdyzWAW",
tKnhdtFSpW = "tKnhdtFSpW",
kWnEWYUNet = "kWnEWYUNet",
ppzYSsHkWf = "ppzYSsHkWf",
jhFnJTxiys = "jhFnJTxiys",
UxUzFturna = "UxUzFturna",
SgeKxEILrE = "SgeKxEILrE",
iZOSQYeiOA = "iZOSQYeiOA",
lmPdzFtuoI = "lmPdzFtuoI",
NjPJBETNGn = "NjPJBETNGn",
NySjySGnjV = "NySjySGnjV",
ruPwKOkfbd = "ruPwKOkfbd",
ueRqTBLPwh = "ueRqTBLPwh",
JyXdtacDcu = "JyXdtacDcu",
KlODFkcBWa = "KlODFkcBWa",
eIepXtAyaC = "eIepXtAyaC",
GntjtDfCRO = "GntjtDfCRO",
apEOylDQhW = "apEOylDQhW",
IWcehxhIjO = "IWcehxhIjO",
WqxumkMsoY = "WqxumkMsoY",
taMTeprCBT = "taMTeprCBT",
ALMrrJrJIe = "ALMrrJrJIe",
JmAUEtIJgy = "JmAUEtIJgy",
vgnTWOYXdQ = "vgnTWOYXdQ",
IQEiZzxlhn = "IQEiZzxlhn",
mmGDKiNFQn = "mmGDKiNFQn",
lXqCIOtMrk = "lXqCIOtMrk",
iQsJrriQCg = "iQsJrriQCg",
GCZDIsGAfC = "GCZDIsGAfC",
eeInyMHFYZ = "eeInyMHFYZ",
qZeYWQBlwq = "qZeYWQBlwq",
mxEFaZuDiM = "mxEFaZuDiM",
xCIorGWvVj = "xCIorGWvVj",
yzoFZmnNtr = "yzoFZmnNtr",
tCSVEEeTXc = "tCSVEEeTXc",
GrWHlzQVEs = "GrWHlzQVEs",
NropgemEEI = "NropgemEEI",
kruynHekHX = "kruynHekHX",
dmqbeqWNhi = "dmqbeqWNhi",
ZhXwSfRHfw = "ZhXwSfRHfw",
LxNlVcIyHV = "LxNlVcIyHV",
rGMQlOAeFg = "rGMQlOAeFg",
xHBIGjYGAD = "xHBIGjYGAD",
vcMltjaUIu = "vcMltjaUIu",
uBbEVuIFrJ = "uBbEVuIFrJ",
jfJFiueVir = "jfJFiueVir",
gSaYIzZCwM = "gSaYIzZCwM",
nfVTEcHMvj = "nfVTEcHMvj",
AlWNuhbBwP = "AlWNuhbBwP",
oCvkTtjnLP = "oCvkTtjnLP",
buuNKtuVLq = "buuNKtuVLq",
fdFtMCrYOG = "fdFtMCrYOG",
HSesqjRGgz = "HSesqjRGgz",
vwTrQftCHP = "vwTrQftCHP",
rqJOarArue = "rqJOarArue",
oZrUtUPDun = "oZrUtUPDun",
EtMsWYPbYn = "EtMsWYPbYn",
ZYhergjdQt = "ZYhergjdQt",
qiMIGQhGac = "qiMIGQhGac",
VHgRtztQje = "VHgRtztQje",
DxvjVduPtq = "DxvjVduPtq",
hvdwfJfPUl = "hvdwfJfPUl",
AhsnIGaAuw = "AhsnIGaAuw",
jjESrXQGKO = "jjESrXQGKO",
QAKKmYXUpj = "QAKKmYXUpj",
eMHTfjnglu = "eMHTfjnglu",
BrHzxKwHCb = "BrHzxKwHCb",
JpJtuTCtSp = "JpJtuTCtSp",
etaeObWuaE = "etaeObWuaE",
jfecMwEjDK = "jfecMwEjDK",
LnYNqAMBPh = "LnYNqAMBPh",
hLheLwFBDY = "hLheLwFBDY",
jJQDtOmGvH = "jJQDtOmGvH",
vgDyLmyxbP = "vgDyLmyxbP",
DrVfEljHhe = "DrVfEljHhe",
ZQMuwvSZoI = "ZQMuwvSZoI",
LUCCEixKob = "LUCCEixKob",
dueEZnOqkj = "dueEZnOqkj",
gfgyeexYQN = "gfgyeexYQN",
vzWubsxweJ = "vzWubsxweJ",
mEJshEfIua = "mEJshEfIua",
fzRJwqmeuX = "fzRJwqmeuX",
rEABNCttuA = "rEABNCttuA",
WzHdVlFxEb = "WzHdVlFxEb",
ytiuUcgUIM = "ytiuUcgUIM",
LzbevUEzky = "LzbevUEzky",
OnitaEQBIr = "OnitaEQBIr",
eJJzMMtvnV = "eJJzMMtvnV",
rXlZuesoyd = "rXlZuesoyd",
tSUTEsoBHL = "tSUTEsoBHL",
NuNwRQWJyE = "NuNwRQWJyE",
budHlTOoBq = "budHlTOoBq",
GstXdVPaLh = "GstXdVPaLh",
NZivMorHVF = "NZivMorHVF",
rHCsdceAIO = "rHCsdceAIO",
BrwreLjXMP = "BrwreLjXMP",
GZsDkZKqRU = "GZsDkZKqRU",
RimrNNfJDU = "RimrNNfJDU",
FzjQoyMsfh = "FzjQoyMsfh",
highUtvWOl = "highUtvWOl",
ehyEGvErCH = "ehyEGvErCH",
rWxgjewDLO = "rWxgjewDLO",
QexRrHsZzf = "QexRrHsZzf",
uQheqrZPrW = "uQheqrZPrW",
UUufoUTZpE = "UUufoUTZpE",
NZpIuSIctd = "NZpIuSIctd",
VUMQHsDfaq = "VUMQHsDfaq",
yOdSQfbJuW = "yOdSQfbJuW",
pfyUxpeHhD = "pfyUxpeHhD",
uDegZuoYur = "uDegZuoYur",
DqSoqruNMf = "DqSoqruNMf",
UNuwVHuumD = "UNuwVHuumD",
HsjMFobdqu = "HsjMFobdqu",
rQMypdNrBM = "rQMypdNrBM",
yZExcBtkfK = "yZExcBtkfK",
NhvWorQCDH = "NhvWorQCDH",
HgznaMfvBs = "HgznaMfvBs",
PADtctrIzG = "PADtctrIzG",
DHRmXSyagq = "DHRmXSyagq",
pGSrtDaUFr = "pGSrtDaUFr",
ABfgyrTWeN = "ABfgyrTWeN",
PoDZdUfztN = "PoDZdUfztN",
SoGxrrXLtI = "SoGxrrXLtI",
SzceYOIBrs = "SzceYOIBrs",
uJehrZNuPG = "uJehrZNuPG",
adeqojlpbY = "adeqojlpbY",
qJAttECJRW = "qJAttECJRW",
BqDCWAziqe = "BqDCWAziqe",
vygHMLzrrS = "vygHMLzrrS",
NkGSYCBkDe = "NkGSYCBkDe",
dDPaHxRRyW = "dDPaHxRRyW",
oQuArTgdLU = "oQuArTgdLU",
ULytztWngw = "ULytztWngw",
juYOoSXVoU = "juYOoSXVoU",
pZNHcMiYsa = "pZNHcMiYsa",
LStwWtwHYj = "LStwWtwHYj",
rdUrdXtEsT = "rdUrdXtEsT",
dWcATjMApp = "dWcATjMApp",
bKSAngxavN = "bKSAngxavN",
yKPWaCmuzQ = "yKPWaCmuzQ",
svKMYpSYIj = "svKMYpSYIj",
dwynRuWuyq = "dwynRuWuyq",
alsOKgLRTl = "alsOKgLRTl",
WrMicHGkmL = "WrMicHGkmL",
BteMctflZZ = "BteMctflZZ",
SSSrKmSyju = "SSSrKmSyju",
nzHiiaUVLF = "nzHiiaUVLF",
ZQGuNcufgA = "ZQGuNcufgA",
pdOiDwxHut = "pdOiDwxHut",
GNrrewVuWM = "GNrrewVuWM",
JICufiJGLQ = "JICufiJGLQ",
YFHFtubIty = "YFHFtubIty",
ezeGShaBml = "ezeGShaBml",
kKZMEFEYSq = "kKZMEFEYSq",
vRKnEoguRc = "vRKnEoguRc",
JSeCJfReQr = "JSeCJfReQr",
tzVrqBjrtc = "tzVrqBjrtc",
svaitVarae = "svaitVarae",
zDCJVgrdKq = "zDCJVgrdKq",
uiULVSYTgE = "uiULVSYTgE",
jocNkSiZRL = "jocNkSiZRL",
zkFDELffvG = "zkFDELffvG",
fmgPQVofzS = "fmgPQVofzS",
UHwJLbtYqC = "UHwJLbtYqC",
eJvzoOyFbL = "eJvzoOyFbL",
DuZOrMyQUB = "DuZOrMyQUB",
SoZYLWsjUp = "SoZYLWsjUp",
sVoyNrnsnG = "sVoyNrnsnG",
AIMrmXiGnL = "AIMrmXiGnL",
WMWSRgmDJC = "WMWSRgmDJC",
PsBvzQbjsI = "PsBvzQbjsI",
tYUieGuSJY = "tYUieGuSJY",
ZkKAYjJFfk = "ZkKAYjJFfk",
eeqoDLdKEA = "eeqoDLdKEA",
utyFPebdge = "utyFPebdge",
AtIFOlReFh = "AtIFOlReFh",
prbrmMcROW = "prbrmMcROW",
FBPwQgptgN = "FBPwQgptgN",
muOyQECHzB = "muOyQECHzB",
XmHGLMyZce = "XmHGLMyZce",
cPADCiwXfx = "cPADCiwXfx",
uFowtxMKtV = "uFowtxMKtV",
rrAtYEgPBN = "rrAtYEgPBN",
ZSSaoujcPr = "ZSSaoujcPr",
rqXlSoeDrX = "rqXlSoeDrX",
wUmfYAelsR = "wUmfYAelsR",
tCnDbdJLZo = "tCnDbdJLZo",
STFVxonkce = "STFVxonkce",
JcjBCSiOXr = "JcjBCSiOXr",
UAgynTfQEi = "UAgynTfQEi",
juVaquZGiv = "juVaquZGiv",
uonDkkIZal = "uonDkkIZal",
CxenRfHKUe = "CxenRfHKUe",
snepZIMsur = "snepZIMsur",
cugEmMzhRu = "cugEmMzhRu",
EmHtmNIndF = "EmHtmNIndF",
FxEIYtMvul = "FxEIYtMvul",
cWdfoXnupw = "cWdfoXnupw",
IjNBttVDOp = "IjNBttVDOp",
beQczYhsNQ = "beQczYhsNQ",
ciIivIOmXk = "ciIivIOmXk",
PBSNxATUuG = "PBSNxATUuG",
utYbzYMKKt = "utYbzYMKKt",
mpzCWVFUPY = "mpzCWVFUPY",
erjwDuRfnt = "erjwDuRfnt",
yGrlwrRrQr = "yGrlwrRrQr",
cxGOYRxirz = "cxGOYRxirz",
BbWSnTJZQj = "BbWSnTJZQj",
yextGadIbG = "yextGadIbG",
gbRsGHbtrq = "gbRsGHbtrq",
HEZSNRuxQu = "HEZSNRuxQu",
fPRAnRalTY = "fPRAnRalTY",
tubzNnrbLp = "tubzNnrbLp",
wFKmmgdweQ = "wFKmmgdweQ",
sceyKljgdr = "sceyKljgdr",
GaaDjBnMdo = "GaaDjBnMdo",
CJtvRCRabi = "CJtvRCRabi",
AidZSXiZWw = "AidZSXiZWw",
FuLEtCStUN = "FuLEtCStUN",
MqRCsolupZ = "MqRCsolupZ",
knNUorCgQV = "knNUorCgQV",
iiAaicBwuz = "iiAaicBwuz",
eoKjjsYCgu = "eoKjjsYCgu",
rqirrqIKuA = "rqirrqIKuA",
QBdzqGrtNj = "QBdzqGrtNj",
tUCOrtfbeu = "tUCOrtfbeu",
eBBunlSGhu = "eBBunlSGhu",
rfxcAJvLGW = "rfxcAJvLGW",
KcHMsuUDzC = "KcHMsuUDzC",
nTlTiuXrHW = "nTlTiuXrHW",
attFzeTBxu = "attFzeTBxu",
zLhYBWkyUZ = "zLhYBWkyUZ",
pvMBzJztSh = "pvMBzJztSh",
mMQnrehXsI = "mMQnrehXsI",
AqCEyrNTCw = "AqCEyrNTCw",
vxlObeNCfM = "vxlObeNCfM",
FXbZlAzNdI = "FXbZlAzNdI",
rxLtLfkiOm = "rxLtLfkiOm",
aEurEIcgDi = "aEurEIcgDi",
WzGnBsgIZf = "WzGnBsgIZf",
gErhXqHJVx = "gErhXqHJVx",
mEPdEVdpeu = "mEPdEVdpeu",
yXMCZtzawa = "yXMCZtzawa",
IQLwZKeolX = "IQLwZKeolX",
wJRYSUtOfe = "wJRYSUtOfe",
ClUCTBJJml = "ClUCTBJJml",
ZLHwFLaCbj = "ZLHwFLaCbj",
aypkHXXsuN = "aypkHXXsuN",
buoDEMqifD = "buoDEMqifD",
LoDnZasfKL = "LoDnZasfKL",
IYRQLUqfiX = "IYRQLUqfiX",
DQuPlwtSkJ = "DQuPlwtSkJ",
IzjtAlFwwr = "IzjtAlFwwr",
EKelNFhqBI = "EKelNFhqBI",
FPeprOpbQG = "FPeprOpbQG",
MICYmaTBuC = "MICYmaTBuC",
thGdcEgNzH = "thGdcEgNzH",
WTLCtKaGcv = "WTLCtKaGcv",
TwhmJavppw = "TwhmJavppw",
pJSrvWWlTe = "pJSrvWWlTe",
LXDvuyWtMW = "LXDvuyWtMW",
uzwsteentU = "uzwsteentU",
liNMkQYied = "liNMkQYied",
ZFGUqborZF = "ZFGUqborZF",
zMtkyHvbjH = "zMtkyHvbjH",
enHKhYJAsG = "enHKhYJAsG",
boPDXSIXoY = "boPDXSIXoY",
wRMbpkvGQI = "wRMbpkvGQI",
MahKKHUPMR = "MahKKHUPMR",
GTepAfYzHQ = "GTepAfYzHQ",
vcJbsHrAgD = "vcJbsHrAgD",
wcDuCzRyWD = "wcDuCzRyWD",
VDFOKBNOFr = "VDFOKBNOFr",
GLbPemcJhh = "GLbPemcJhh",
CdnAhVCojd = "CdnAhVCojd",
elyWzeeIvE = "elyWzeeIvE",
iYroJpxOAm = "iYroJpxOAm",
KRNulujxMB = "KRNulujxMB",
sTFgkEebqW = "sTFgkEebqW",
NotNAkWwSt = "NotNAkWwSt",
GpcZvjufIR = "GpcZvjufIR",
exREBudVUy = "exREBudVUy",
mXVtlUEcXl = "mXVtlUEcXl",
oVnFmnRJZm = "oVnFmnRJZm",
WrPbtOaFsY = "WrPbtOaFsY",
MWtLnMmLsu = "MWtLnMmLsu",
taGrDepGne = "taGrDepGne",
PtLiaENITr = "PtLiaENITr",
eNneOSnnkv = "eNneOSnnkv",
lwMGlrQQzu = "lwMGlrQQzu",
UtYTXJEhgZ = "UtYTXJEhgZ",
djbewdrZen = "djbewdrZen",
tZuBGttKii = "tZuBGttKii",
aJdRcExrrV = "aJdRcExrrV",
zbhSYcgJdW = "zbhSYcgJdW",
tnjgHFsyJR = "tnjgHFsyJR",
CEiJNatuyz = "CEiJNatuyz",
AnKxqrqjKX = "AnKxqrqjKX",
ZGNYefxfUe = "ZGNYefxfUe",
ZOlrDZXVxn = "ZOlrDZXVxn",
buNPyWwrsu = "buNPyWwrsu",
wjXLrgGmmA = "wjXLrgGmmA",
QiCtNQAdfz = "QiCtNQAdfz",
ttjozCjiiI = "ttjozCjiiI",
rJmPeZLOjc = "rJmPeZLOjc",
DBSWvzpzXx = "DBSWvzpzXx",
PasdYeMqWq = "PasdYeMqWq",
uObUfPDZXh = "uObUfPDZXh",
vRbpkUlrbF = "vRbpkUlrbF",
tHUbRuBCpE = "tHUbRuBCpE",
ijrelWQMsf = "ijrelWQMsf",
WgKzfptTKM = "WgKzfptTKM",
WbZeuhEABZ = "WbZeuhEABZ",
DPDpOWPQqR = "DPDpOWPQqR",
peefoItVUz = "peefoItVUz",
IXTxpHVFzY = "IXTxpHVFzY",
gGdflXeKQx = "gGdflXeKQx",
ctkbEJCllN = "ctkbEJCllN",
KeupipeniK = "KeupipeniK",
WRrJvksNsN = "WRrJvksNsN",
DEcmIGTfQK = "DEcmIGTfQK",
QZcPeKrHIU = "QZcPeKrHIU",
bpkVusrukO = "bpkVusrukO",
mAFliUNNCg = "mAFliUNNCg",
seuxJPLWmD = "seuxJPLWmD",
HfrBBAtEEl = "HfrBBAtEEl",
yXDBijXchO = "yXDBijXchO",
bYJeSwNKin = "bYJeSwNKin",
oCSvHecIJH = "oCSvHecIJH",
kDruNGrKUH = "kDruNGrKUH",
mbVbrWEpDI = "mbVbrWEpDI",
koRacYKqhb = "koRacYKqhb",
RuFNKIFwug = "RuFNKIFwug",
gthWyfxpGu = "gthWyfxpGu",
aeAOlkLAmY = "aeAOlkLAmY",
yAzZQwYwZg = "yAzZQwYwZg",
LyunrweDTS = "LyunrweDTS",
GhrnWNqziK = "GhrnWNqziK",
WSqJxyrxEp = "WSqJxyrxEp",
HArGHsonDO = "HArGHsonDO",
cBwRAczTpt = "cBwRAczTpt",
usElnwiFYe = "usElnwiFYe",
kOiiZIIoyn = "kOiiZIIoyn",
DRkSkOlrVn = "DRkSkOlrVn",
fVMhjuNpWg = "fVMhjuNpWg",
OTbHeCVNcA = "OTbHeCVNcA",
uOledxkXLi = "uOledxkXLi",
rMTTfGnyzk = "rMTTfGnyzk",
tOUYVKsqyT = "tOUYVKsqyT",
uQJGdbpJjx = "uQJGdbpJjx",
KBVurEuStV = "KBVurEuStV",
tgEvumuvPt = "tgEvumuvPt",
ROeObdPdtD = "ROeObdPdtD",
DgGeKjmtaL = "DgGeKjmtaL",
UaEmhJBtOD = "UaEmhJBtOD",
eNetBtjYau = "eNetBtjYau",
KUQOklgOra = "KUQOklgOra",
mdhcBttJre = "mdhcBttJre",
dCbePpzZur = "dCbePpzZur",
aPYYxShCup = "aPYYxShCup",
xWpQPqSSFt = "xWpQPqSSFt",
DWfezahRfj = "DWfezahRfj",
DbPtKqBrjh = "DbPtKqBrjh",
wXVJQvUOIy = "wXVJQvUOIy",
nhraNMKLSQ = "nhraNMKLSQ",
fFpARHyfSo = "fFpARHyfSo",
fDKNkIQfxF = "fDKNkIQfxF",
DArfhbjSka = "DArfhbjSka",
SmvHBWerXz = "SmvHBWerXz",
QGEcizDhnx = "QGEcizDhnx",
aicNFBOuVP = "aicNFBOuVP",
FTrrkFvqKc = "FTrrkFvqKc",
EDhIoVNuyr = "EDhIoVNuyr",
AzteQazXtU = "AzteQazXtU",
RuglMGaCEe = "RuglMGaCEe",
FyyOKtYSDc = "FyyOKtYSDc",
JWnvuCuqtN = "JWnvuCuqtN",
ZoBjMerIVC = "ZoBjMerIVC",
WdlrTyTDzs = "WdlrTyTDzs",
WviFMLruUf = "WviFMLruUf",
uUtFfJtfSq = "uUtFfJtfSq",
ALfNxVNYru = "ALfNxVNYru",
fPYMmVXxru = "fPYMmVXxru",
xoZvIcXlMK = "xoZvIcXlMK",
PZvAsFbQFT = "PZvAsFbQFT",
XrJgGhXnQg = "XrJgGhXnQg",
LBszHtGdzw = "LBszHtGdzw",
TMqExeEzvo = "TMqExeEzvo",
BFjzobBJLE = "BFjzobBJLE",
gzaXrIDscj = "gzaXrIDscj",
uKmgYdSpOa = "uKmgYdSpOa",
wnMOHIPrac = "wnMOHIPrac",
OktkVPwODo = "OktkVPwODo",
tgkGtSeOSs = "tgkGtSeOSs",
xUcQwhXeSd = "xUcQwhXeSd",
SCXUuJtGtO = "SCXUuJtGtO",
yxylXuCttj = "yxylXuCttj",
ITapCVCnHo = "ITapCVCnHo",
LnueWqYLOb = "LnueWqYLOb",
SioveFVDsV = "SioveFVDsV",
LPrPlzYvKM = "LPrPlzYvKM",
jeNCDNyppy = "jeNCDNyppy",
IrlXarpWtB = "IrlXarpWtB",
kCGHgFOiZY = "kCGHgFOiZY",
yAHcfbNeHX = "yAHcfbNeHX",
earDwndLRB = "earDwndLRB",
jJkmTXzhBN = "jJkmTXzhBN",
hSqBxdethp = "hSqBxdethp",
mGeArGDsPe = "mGeArGDsPe",
IOtJRYzxza = "IOtJRYzxza",
xtEQxFbhGX = "xtEQxFbhGX",
teJjJIsNQL = "teJjJIsNQL",
mCNnVYrEvT = "mCNnVYrEvT",
LAFTFPUYxr = "LAFTFPUYxr",
DrRrDkrIkO = "DrRrDkrIkO",
XxztdknXgC = "XxztdknXgC",
AgRWLjpCZU = "AgRWLjpCZU",
DpGlEbktgm = "DpGlEbktgm",
HffCZuYeTj = "HffCZuYeTj",
HTouParPGW = "HTouParPGW",
ZcVXWwztuI = "ZcVXWwztuI",
YXwoAtqUuE = "YXwoAtqUuE",
FWJahteUzY = "FWJahteUzY",
auzvAMswuO = "auzvAMswuO",
dVgUEWbPnG = "dVgUEWbPnG",
hMUJwOJAla = "hMUJwOJAla",
trYOoNdrhi = "trYOoNdrhi",
JeZtrsabwB = "JeZtrsabwB",
uvTrdhjYLK = "uvTrdhjYLK",
rNSVOJCNdF = "rNSVOJCNdF",
gzmgVkAUPI = "gzmgVkAUPI",
tBMbsJljXr = "tBMbsJljXr",
uXYYodAaTk = "uXYYodAaTk",
lSLuveRnCe = "lSLuveRnCe",
XrYLecSrSY = "XrYLecSrSY",
wpySoLGoVB = "wpySoLGoVB",
hFYMEsbhOt = "hFYMEsbhOt",
eYwuPRrxYE = "eYwuPRrxYE",
pPQVwiCMPM = "pPQVwiCMPM",
dQZaIiIOWu = "dQZaIiIOWu",
DAVvyQKler = "DAVvyQKler",
QfueXqtpzH = "QfueXqtpzH",
TrQkWRAIvS = "TrQkWRAIvS",
khrmgPVlRc = "khrmgPVlRc",
etXqLLltTh = "etXqLLltTh",
eGJMutrerA = "eGJMutrerA",
qYsOjXnodv = "qYsOjXnodv",
icOVLuOJMr = "icOVLuOJMr",
AUxEpOIReC = "AUxEpOIReC",
uLcrGlLngE = "uLcrGlLngE",
HfrSRnxyDL = "HfrSRnxyDL",
OeRQPeUmLe = "OeRQPeUmLe",
fcCEIskuIh = "fcCEIskuIh",
QGDEVAaWMf = "QGDEVAaWMf",
jhuOGWObhl = "jhuOGWObhl",
iwddjNbTLj = "iwddjNbTLj",
kVGYitOwSF = "kVGYitOwSF",
zoDuofGpOc = "zoDuofGpOc",
PnZWgylblB = "PnZWgylblB",
jaADvtCHeR = "jaADvtCHeR",
xITdpMaoRl = "xITdpMaoRl",
OuiPoWpObF = "OuiPoWpObF",
ctGmKcanrt = "ctGmKcanrt",
ykgdGZeOco = "ykgdGZeOco",
xxnMDbdGwl = "xxnMDbdGwl",
iVclqTzDaV = "iVclqTzDaV",
XDmyoQgfGJ = "XDmyoQgfGJ",
krGMohQbIF = "krGMohQbIF",
MUOuLgYOga = "MUOuLgYOga",
pShOXuPubi = "pShOXuPubi",
YWnutrzfNZ = "YWnutrzfNZ",
kZibZgoDED = "kZibZgoDED",
IURISqDrtm = "IURISqDrtm",
kCDhlliiku = "kCDhlliiku",
oPthPudGLG = "oPthPudGLG",
tgmCYAHafi = "tgmCYAHafi",
SWmzXoTZxA = "SWmzXoTZxA",
pzTvMoJGXt = "pzTvMoJGXt",
mDwzbJlrQb = "mDwzbJlrQb",
MiXgvrlpuN = "MiXgvrlpuN",
CADtDsIXJR = "CADtDsIXJR",
qJRaYDDKuE = "qJRaYDDKuE",
ZRzErqfqYJ = "ZRzErqfqYJ",
UmMVHRlurP = "UmMVHRlurP",
FzPZbIVHlW = "FzPZbIVHlW",
RluQrWAguL = "RluQrWAguL",
BcOXsXmKkl = "BcOXsXmKkl",
gPMtmoZZBk = "gPMtmoZZBk",
qQHFynnlws = "qQHFynnlws",
KlakyDqAar = "KlakyDqAar",
oubxbOYNJi = "oubxbOYNJi",
AgnwWhiooQ = "AgnwWhiooQ",
zKJCqFKFQv = "zKJCqFKFQv",
iuOpuTPhVn = "iuOpuTPhVn",
xQBudgOsNh = "xQBudgOsNh",
obQlhSDQSq = "obQlhSDQSq",
sVWYVGrbGK = "sVWYVGrbGK",
NIxJPLWiFo = "NIxJPLWiFo",
YqJHTEerwU = "YqJHTEerwU",
YLyJeItngr = "YLyJeItngr",
tNoBqKcMtQ = "tNoBqKcMtQ",
GOEOPtGfSc = "GOEOPtGfSc",
zicuknGtEX = "zicuknGtEX",
xXAPclUEgv = "xXAPclUEgv",
GqqFCXFuuq = "GqqFCXFuuq",
CZiiEygoUe = "CZiiEygoUe",
qpqkRWpZNr = "qpqkRWpZNr",
hYeMmmNGtD = "hYeMmmNGtD",
pgVlIgItor = "pgVlIgItor",
GuNkhcMBIz = "GuNkhcMBIz",
sPBYthdSkm = "sPBYthdSkm",
ZifetuBagP = "ZifetuBagP",
auwwGyUCJh = "auwwGyUCJh",
VCtjYhfkrJ = "VCtjYhfkrJ",
QbkyFtxRPo = "QbkyFtxRPo",
yXVgjLQHzY = "yXVgjLQHzY",
pwaiOvTwiG = "pwaiOvTwiG",
CbtAWZqtnp = "CbtAWZqtnp",
TiESqmdbPz = "TiESqmdbPz",
HGaguPvMgt = "HGaguPvMgt",
xerqWvFzED = "xerqWvFzED",
SAPEkWRUXk = "SAPEkWRUXk",
rMtGrfteFa = "rMtGrfteFa",
leHRiwJdEW = "leHRiwJdEW",
IzVYTHuEHj = "IzVYTHuEHj",
vIOYvleptW = "vIOYvleptW",
AHAyrzrPgB = "AHAyrzrPgB",
IWwxTJjNgo = "IWwxTJjNgo",
gtNCuzjzfn = "gtNCuzjzfn",
BCveslCCGt = "BCveslCCGt",
DskWxAweoB = "DskWxAweoB",
wcaDauoKmx = "wcaDauoKmx",
dgteqYBybP = "dgteqYBybP",
XVqjgSubQW = "XVqjgSubQW",
SqIirvdehu = "SqIirvdehu",
BezOzFeBaM = "BezOzFeBaM",
tLSITBeruu = "tLSITBeruu",
DkcOGmUiuf = "DkcOGmUiuf",
mtrWmZdmvd = "mtrWmZdmvd",
jHtIxmUred = "jHtIxmUred",
AtPBDNAjZn = "AtPBDNAjZn",
ocEuVPkKEz = "ocEuVPkKEz",
eBuOnNVxed = "eBuOnNVxed",
cEwZrQDKfd = "cEwZrQDKfd",
euaXmsdJuk = "euaXmsdJuk",
aUTNtUrieH = "aUTNtUrieH",
bKVZQCSfja = "bKVZQCSfja",
XMVjnWJfGF = "XMVjnWJfGF",
xQJtPTGvVW = "xQJtPTGvVW",
NWwIrgnZYV = "NWwIrgnZYV",
ZNGlguYyBr = "ZNGlguYyBr",
mYpfXkvNky = "mYpfXkvNky",
QrzSrjnrho = "QrzSrjnrho",
CrPCEDmnzR = "CrPCEDmnzR",
eVNGSpZOvl = "eVNGSpZOvl",
YxJTKXEwba = "YxJTKXEwba",
nVfOLcSNuY = "nVfOLcSNuY",
CHDmOCvEWO = "CHDmOCvEWO",
jdqKUAYlUc = "jdqKUAYlUc",
bfaIeOvCPQ = "bfaIeOvCPQ",
GwsehKYrJB = "GwsehKYrJB",
brkNNDRopL = "brkNNDRopL",
oawQLKaUKm = "oawQLKaUKm",
EDixUtGehH = "EDixUtGehH",
vqgqxjmNwr = "vqgqxjmNwr",
EsiXsrrrLg = "EsiXsrrrLg",
FtvncYvyAo = "FtvncYvyAo",
HqYZjmaktu = "HqYZjmaktu",
xENXYJwtRw = "xENXYJwtRw",
yxWSSySjgT = "yxWSSySjgT",
xyFDRujcrQ = "xyFDRujcrQ",
ZuBvyrwlFJ = "ZuBvyrwlFJ",
xWrCsPbuPT = "xWrCsPbuPT",
JuPRmbiZiX = "JuPRmbiZiX",
esOqgrUbnt = "esOqgrUbnt",
rcoRPNSLuD = "rcoRPNSLuD",
wgefmUIrSr = "wgefmUIrSr",
MtctGYWztz = "MtctGYWztz",
lZKuQfcuUu = "lZKuQfcuUu",
FhQeXZtAiV = "FhQeXZtAiV",
iDgCTlgDTG = "iDgCTlgDTG",
eWuWBjZrYE = "eWuWBjZrYE",
EGrqGhBrya = "EGrqGhBrya",
XDVeFPYemT = "XDVeFPYemT",
punRJSGpue = "punRJSGpue",
rWHcdAkvaM = "rWHcdAkvaM",
lRuKMDVltC = "lRuKMDVltC",
OJrhNKRpIc = "OJrhNKRpIc",
hsUisrvmdg = "hsUisrvmdg",
JecwzNKXNN = "JecwzNKXNN",
nYzhATMRoe = "nYzhATMRoe",
TZwOnfHJbg = "TZwOnfHJbg",
GkCNrHtRfa = "GkCNrHtRfa",
UTqkawMceR = "UTqkawMceR",
YGznpVgEuW = "YGznpVgEuW",
foGojLSiCp = "foGojLSiCp",
cWFTzsCzGO = "cWFTzsCzGO",
euinXLliAC = "euinXLliAC",
UnQqBQzUme = "UnQqBQzUme",
XAHiQzLseq = "XAHiQzLseq",
GGprJhEpiH = "GGprJhEpiH",
pyrDoLohAh = "pyrDoLohAh",
unvySWmVXI = "unvySWmVXI",
BOdXpbxKYP = "BOdXpbxKYP",
aicaBRffzA = "aicaBRffzA",
LgfdztQtVb = "LgfdztQtVb",
gAWKGMeKEX = "gAWKGMeKEX",
xSBifLDSge = "xSBifLDSge",
HFwckMDMVA = "HFwckMDMVA",
skbQPfqdta = "skbQPfqdta",
FguVyeHZnI = "FguVyeHZnI",
wYmIrRDMEX = "wYmIrRDMEX",
twrrHGgKTV = "twrrHGgKTV",
kenAhIQslt = "kenAhIQslt",
SshdIfDfxA = "SshdIfDfxA",
SQuVUYYOnP = "SQuVUYYOnP",
HNWwcVHfwE = "HNWwcVHfwE",
HtyqxCjamH = "HtyqxCjamH",
MtRKoHqtUm = "MtRKoHqtUm",
BiyMTZBPmN = "BiyMTZBPmN",
feuqXBywNY = "feuqXBywNY",
iAPjcMODrH = "iAPjcMODrH",
tTJBEprJVL = "tTJBEprJVL",
xrEveteHBU = "xrEveteHBU",
aDzxEttEin = "aDzxEttEin",
vecguiRRWV = "vecguiRRWV",
unHqdRqgee = "unHqdRqgee",
IMkOurYeQt = "IMkOurYeQt",
QctZXeZPVf = "QctZXeZPVf",
uHnhyzBuDz = "uHnhyzBuDz",
YBvJOrUIeQ = "YBvJOrUIeQ",
kuctQtBdtv = "kuctQtBdtv",
BTTXyFclcv = "BTTXyFclcv",
rrvUTTgZQt = "rrvUTTgZQt",
AWGxCUCuHi = "AWGxCUCuHi",
rvAYtYYMKs = "rvAYtYYMKs",
qfNDSAnJAQ = "qfNDSAnJAQ",
MwprAlkYoz = "MwprAlkYoz",
GaeHYYelrf = "GaeHYYelrf",
reJVtBtTQp = "reJVtBtTQp",
PMbBSaCtxo = "PMbBSaCtxo",
wRtCTatbTe = "wRtCTatbTe",
fYMprQwMVU = "fYMprQwMVU",
qXDVEZIrbd = "qXDVEZIrbd",
SDZAAuLMNr = "SDZAAuLMNr",
FMGlmeLGkb = "FMGlmeLGkb",
isVIyFvDhP = "isVIyFvDhP",
SFgqASxGBz = "SFgqASxGBz",
AbHcqbLDsD = "AbHcqbLDsD",
wnizrTkAsW = "wnizrTkAsW",
rnjAQVebfz = "rnjAQVebfz",
BrnMLrsPXf = "BrnMLrsPXf",
YPjxppNuah = "YPjxppNuah",
fzOWdmOkqP = "fzOWdmOkqP",
XxQKerOaIp = "XxQKerOaIp",
rgspcSmGmU = "rgspcSmGmU",
yAluzWchRP = "yAluzWchRP",
KptHwnEdYe = "KptHwnEdYe",
aaMdFxfepe = "aaMdFxfepe",
KhjxuYdMIr = "KhjxuYdMIr",
ZyLYGomdef = "ZyLYGomdef",
PdPRPtkFLx = "PdPRPtkFLx",
aMnGEVmyfR = "aMnGEVmyfR",
YFgkvDGlmY = "YFgkvDGlmY",
iVhGtdfVTZ = "iVhGtdfVTZ",
kpRopuBPQT = "kpRopuBPQT",
tdMjRLTvHw = "tdMjRLTvHw",
wrIAvZNYki = "wrIAvZNYki",
KRnEbrwuot = "KRnEbrwuot",
hdgzzcueJn = "hdgzzcueJn",
nzlBCgezZl = "nzlBCgezZl",
bZCXpfimlE = "bZCXpfimlE",
gUdBbYcXZh = "gUdBbYcXZh",
eofVjaSfnx = "eofVjaSfnx",
kfdZerHyrR = "kfdZerHyrR",
IUhGEwwfMW = "IUhGEwwfMW",
MCWBzNnBez = "MCWBzNnBez",
MFHAmxrLyZ = "MFHAmxrLyZ",
mXypdoesej = "mXypdoesej",
ReXtPmGesg = "ReXtPmGesg",
tLSZlkrBzL = "tLSZlkrBzL",
XGnBaFEpOm = "XGnBaFEpOm",
PovVOCsOJj = "PovVOCsOJj",
OJuQruBaCt = "OJuQruBaCt",
SKXneptmlr = "SKXneptmlr",
TUbsmLTRWo = "TUbsmLTRWo",
EwqtgBHBYI = "EwqtgBHBYI",
XeiCbNnylX = "XeiCbNnylX",
JkCrrezGQb = "JkCrrezGQb",
VrFlqrbYDi = "VrFlqrbYDi",
ucUdrSdKlr = "ucUdrSdKlr",
VrvyigxvBu = "VrvyigxvBu",
FFjJutHeJz = "FFjJutHeJz",
iTclPFirLe = "iTclPFirLe",
KmCnavebPQ = "KmCnavebPQ",
qwPOmwlVUk = "qwPOmwlVUk",
FprzBcrxwa = "FprzBcrxwa",
vmFeVbdhhj = "vmFeVbdhhj",
HGdnTIvnyl = "HGdnTIvnyl",
rtUOxtVUwy = "rtUOxtVUwy",
kNaslTWDPj = "kNaslTWDPj",
eZDXtxPTYU = "eZDXtxPTYU",
KlRuPbQLOc = "KlRuPbQLOc",
avDeAMVjwP = "avDeAMVjwP",
DqdVpSGfxb = "DqdVpSGfxb",
qBuvcqtYoG = "qBuvcqtYoG",
PuvUIqlbxL = "PuvUIqlbxL",
fdrdSupvWx = "fdrdSupvWx",
rKXosqdute = "rKXosqdute",
rOrDhKaNMe = "rOrDhKaNMe",
ZFuKCUEBuF = "ZFuKCUEBuF",
TGHGdeAIJy = "TGHGdeAIJy",
JjeuAuRHfn = "JjeuAuRHfn",
OMOGEZHhIj = "OMOGEZHhIj",
esCMbrPkgv = "esCMbrPkgv",
LDVwsPdKxX = "LDVwsPdKxX",
VujVFuVdhh = "VujVFuVdhh",
JtIQEOuJuO = "JtIQEOuJuO",
ngQruDksQA = "ngQruDksQA",
tgEpQnbqMI = "tgEpQnbqMI",
GHcwGVxxLR = "GHcwGVxxLR",
ICrHdCKuRM = "ICrHdCKuRM",
YGRimBnDtN = "YGRimBnDtN",
flRtPrCJpO = "flRtPrCJpO",
OpnzaAFHeZ = "OpnzaAFHeZ",
GXSzRxpRDr = "GXSzRxpRDr",
uRQmjvjhyd = "uRQmjvjhyd",
RMXLoDjNmX = "RMXLoDjNmX",
RFiWrWvVTK = "RFiWrWvVTK",
jeLDsZHlel = "jeLDsZHlel",
HbOubrcpkT = "HbOubrcpkT",
XUzmFPecXV = "XUzmFPecXV",
aQRvReWwtn = "aQRvReWwtn",
OmfeIrZGme = "OmfeIrZGme",
dENAgtJqEZ = "dENAgtJqEZ",
waJNuxybWD = "waJNuxybWD",
GcTuewklgx = "GcTuewklgx",
uXdtBKRLUM = "uXdtBKRLUM",
heGuKVVrJr = "heGuKVVrJr",
eUyzChKtUg = "eUyzChKtUg",
WahKAoYSTb = "WahKAoYSTb",
HbzHgSaQRv = "HbzHgSaQRv",
otytuKdarI = "otytuKdarI",
TAeMHnQYgU = "TAeMHnQYgU",
tqeWlHJegT = "tqeWlHJegT",
lLSSqnnyPE = "lLSSqnnyPE",
eTsSyvFjXe = "eTsSyvFjXe",
DNToZtVduF = "DNToZtVduF",
ZtLimqDPtb = "ZtLimqDPtb",
eejyOxGszO = "eejyOxGszO",
ymErjERgXm = "ymErjERgXm",
kyyvGrcuNP = "kyyvGrcuNP",
JVhwurhTlw = "JVhwurhTlw",
YYWiWXuqMI = "YYWiWXuqMI",
nElaPhdHpd = "nElaPhdHpd",
ivBtksTJox = "ivBtksTJox",
dolMmgedeU = "dolMmgedeU",
rXeaItxbud = "rXeaItxbud",
gugSNWqQng = "gugSNWqQng",
drmmJKmlFy = "drmmJKmlFy",
MuceeccrkC = "MuceeccrkC",
CctBHCsMed = "CctBHCsMed",
RmTrfNPELC = "RmTrfNPELC",
CaugcipSqZ = "CaugcipSqZ",
dCzQGjjppe = "dCzQGjjppe",
vUVFZRlVFg = "vUVFZRlVFg",
TSusyyCevF = "TSusyyCevF",
OSfoUFongC = "OSfoUFongC",
rctUAujkcj = "rctUAujkcj",
NKzuGvatag = "NKzuGvatag",
sEfyMsABMr = "sEfyMsABMr",
uXeRMIlshg = "uXeRMIlshg",
PpUpANEhPa = "PpUpANEhPa",
uNMXlSxfUX = "uNMXlSxfUX",
YgFUWTwtUA = "YgFUWTwtUA",
xvOstKPtbA = "xvOstKPtbA",
rqpvoYUXzu = "rqpvoYUXzu",
lHztywrqAp = "lHztywrqAp",
LvzmDuyLRK = "LvzmDuyLRK",
dHCwNafPtN = "dHCwNafPtN",
kRTStGfOIv = "kRTStGfOIv",
cEoVOzJJKu = "cEoVOzJJKu",
giZhwGcKRp = "giZhwGcKRp",
FcQLrFOIHl = "FcQLrFOIHl",
atwvWAIyFx = "atwvWAIyFx",
EmYppCWtPs = "EmYppCWtPs",
zHrRKfrqNZ = "zHrRKfrqNZ",
ytGJUEKPmR = "ytGJUEKPmR",
QHKGuvpqcc = "QHKGuvpqcc",
WjGulUsIte = "WjGulUsIte",
JATFZkxRRw = "JATFZkxRRw",
IVslkJItxf = "IVslkJItxf",
GGvKaIoTQu = "GGvKaIoTQu",
fKKMsXVDNP = "fKKMsXVDNP",
dBjbyjOusA = "dBjbyjOusA",
zOPdKsoVeu = "zOPdKsoVeu",
OYoLPvDtck = "OYoLPvDtck",
eeYMnQfjPp = "eeYMnQfjPp",
ZliKPWMttt = "ZliKPWMttt",
OagfqqthYr = "OagfqqthYr",
Cincrkkufp = "Cincrkkufp",
sAgICLNKOU = "sAgICLNKOU",
EYzgSzwuYt = "EYzgSzwuYt",
YgIvSrBSsV = "YgIvSrBSsV",
qJusBQghSQ = "qJusBQghSQ",
xmtIPXFdqw = "xmtIPXFdqw",
KKyngHKuGf = "KKyngHKuGf",
HSdvnOJGuE = "HSdvnOJGuE",
ZblTkQNuKk = "ZblTkQNuKk",
eBheqHcFmW = "eBheqHcFmW",
CMVtPFMdZk = "CMVtPFMdZk",
yuthaGIBqh = "yuthaGIBqh",
yYRitYWQeE = "yYRitYWQeE",
WYKmyjQNTF = "WYKmyjQNTF",
aeTTaSbICd = "aeTTaSbICd",
ldOPIBrmES = "ldOPIBrmES",
uktBWViziy = "uktBWViziy",
tnDZqebAtm = "tnDZqebAtm",
kMTWGiuWZY = "kMTWGiuWZY",
klMRpalTAE = "klMRpalTAE",
axktrLNUzn = "axktrLNUzn",
FyqtVOEhlK = "FyqtVOEhlK",
ctgAkgYYaD = "ctgAkgYYaD",
oOHHxxAOrv = "oOHHxxAOrv",
feEBivCHsN = "feEBivCHsN",
ewbfSstrsA = "ewbfSstrsA",
ZNieScxTQo = "ZNieScxTQo",
wvDtqFlgsi = "wvDtqFlgsi",
bXyYVlLJxN = "bXyYVlLJxN",
jzLRaWefrD = "jzLRaWefrD",
jJfDFYAtMm = "jJfDFYAtMm",
NTGcODtCZE = "NTGcODtCZE",
BbsYChXxxc = "BbsYChXxxc",
LRieMkLBlt = "LRieMkLBlt",
mYSuDTLebX = "mYSuDTLebX",
tzkHuFpLIT = "tzkHuFpLIT",
ijNuTeKTge = "ijNuTeKTge",
GwBKtuPijq = "GwBKtuPijq",
kejkKrhTuY = "kejkKrhTuY",
FrsIhNtzDq = "FrsIhNtzDq",
tcanxFiKte = "tcanxFiKte",
tbLoYhzgWu = "tbLoYhzgWu",
ZGmSRCGxSN = "ZGmSRCGxSN",
KZqlbHrkot = "KZqlbHrkot",
KODjXMKYGp = "KODjXMKYGp",
kSpGBCecHT = "kSpGBCecHT",
JBGCfUsUXd = "JBGCfUsUXd",
kqJouzMNZZ = "kqJouzMNZZ",
BLguYEtsFu = "BLguYEtsFu",
bdhQPRwbub = "bdhQPRwbub",
nqHyCXIpRu = "nqHyCXIpRu",
IeHFRmgWrJ = "IeHFRmgWrJ",
LsUqVzZKcl = "LsUqVzZKcl",
nEycXtfIex = "nEycXtfIex",
qTsidJxhLz = "qTsidJxhLz",
ZelcYOAsQd = "ZelcYOAsQd",
udIcozQOzV = "udIcozQOzV",
hdSbsPskDQ = "hdSbsPskDQ",
niOxlFtufn = "niOxlFtufn",
fxUevoOnWe = "fxUevoOnWe",
VlilDDeurs = "VlilDDeurs",
pORoqlmNOy = "pORoqlmNOy",
rqtLhMUucF = "rqtLhMUucF",
zdDcXiJrtA = "zdDcXiJrtA",
WBwVzvZCTM = "WBwVzvZCTM",
tedBTyTong = "tedBTyTong",
vItZRcSJli = "vItZRcSJli",
lwhDDuprHL = "lwhDDuprHL",
GSDKKFewQK = "GSDKKFewQK",
StUIejegef = "StUIejegef",
dMIktZzXAS = "dMIktZzXAS",
jostusFpNq = "jostusFpNq",
DySiUNZpeC = "DySiUNZpeC",
aRtsuBxxRK = "aRtsuBxxRK",
rTZUjtYzQQ = "rTZUjtYzQQ",
uELyKKNFjZ = "uELyKKNFjZ",
IrqjBFUnzP = "IrqjBFUnzP",
YIWWXBtJOJ = "YIWWXBtJOJ",
WgHgmGkxYr = "WgHgmGkxYr",
XdevqqfCtB = "XdevqqfCtB",
TGbrubSLOr = "TGbrubSLOr",
vMKGURcAHW = "vMKGURcAHW",
gGzyVhrumU = "gGzyVhrumU",
PFvudCuzTi = "PFvudCuzTi",
rFrQKEZyzV = "rFrQKEZyzV",
XUHufbQEWb = "XUHufbQEWb",
hHvehqRFXZ = "hHvehqRFXZ",
bywgyXRoay = "bywgyXRoay",
XrVXFegGJd = "XrVXFegGJd",
nZrrAleksH = "nZrrAleksH",
aUpAuubnkr = "aUpAuubnkr",
gdDzBrOcOe = "gdDzBrOcOe",
HxBXrKoGpd = "HxBXrKoGpd",
kcljcZiOom = "kcljcZiOom",
thamPeorgR = "thamPeorgR",
rLeAoHrseR = "rLeAoHrseR",
TkNTVrNyQC = "TkNTVrNyQC",
ANJuzmEmxP = "ANJuzmEmxP",
yjmjPwrBeX = "yjmjPwrBeX",
XbQtMrbnTv = "XbQtMrbnTv",
PDeldgAYXH = "PDeldgAYXH",
hyCdPguYML = "hyCdPguYML",
MeyRfoYytg = "MeyRfoYytg",
yruZyyKgRr = "yruZyyKgRr",
ZspqilrUeF = "ZspqilrUeF",
eeEEnFUXOf = "eeEEnFUXOf",
WuYDgPRdTD = "WuYDgPRdTD",
TFUtoIenpf = "TFUtoIenpf",
HjXAhcieRJ = "HjXAhcieRJ",
qpDtqwiuIh = "qpDtqwiuIh",
zZjSVYDega = "zZjSVYDega",
EGkFDiseOf = "EGkFDiseOf",
MmlUllICyo = "MmlUllICyo",
hYWDIOTXqF = "hYWDIOTXqF",
FprNcAueep = "FprNcAueep",
FrmatPIGZV = "FrmatPIGZV",
ZuChYlrEcr = "ZuChYlrEcr",
OrpXHvbquk = "OrpXHvbquk",
XzTqjmgQAW = "XzTqjmgQAW",
iImOPPgDkZ = "iImOPPgDkZ",
DurdYpuEvb = "DurdYpuEvb",
FCtKCmWIDy = "FCtKCmWIDy",
oeayrUpjtP = "oeayrUpjtP",
nLrTnXXpnG = "nLrTnXXpnG",
TCDqNaBOOH = "TCDqNaBOOH",
KzUuNrrWhb = "KzUuNrrWhb",
OxelMqOjLn = "OxelMqOjLn",
LuDaztsDtA = "LuDaztsDtA",
xnbnGZCHqG = "xnbnGZCHqG",
tBsbQnWHED = "tBsbQnWHED",
bhuRhnjfxT = "bhuRhnjfxT",
sIoNopVrhk = "sIoNopVrhk",
PpNtGqRjCk = "PpNtGqRjCk",
TawTdArILw = "TawTdArILw",
jjxuxsMHFt = "jjxuxsMHFt",
mWbeCBmMmm = "mWbeCBmMmm",
eueyEBZOHv = "eueyEBZOHv",
JgqvLPhhkL = "JgqvLPhhkL",
DFOuNftSSa = "DFOuNftSSa",
BeEgHJketo = "BeEgHJketo",
tZZSTWzMan = "tZZSTWzMan",
wImmgFZatP = "wImmgFZatP",
RJNevmUfHy = "RJNevmUfHy",
WSkVxNwUqt = "WSkVxNwUqt",
prducOPavN = "prducOPavN",
ZerFUhHNld = "ZerFUhHNld",
rQYOvaibqA = "rQYOvaibqA",
iuPhCctFrp = "iuPhCctFrp",
xvzGTJIztj = "xvzGTJIztj",
fjXenuHfqM = "fjXenuHfqM",
svIozcBmbm = "svIozcBmbm",
yFHhnABqgh = "yFHhnABqgh",
ktDtzabnPZ = "ktDtzabnPZ",
vadGNCoFOr = "vadGNCoFOr",
aeEkVxWPue = "aeEkVxWPue",
xWXMzjsfnC = "xWXMzjsfnC",
QXEcRnCCTe = "QXEcRnCCTe",
uFgnuUiUig = "uFgnuUiUig",
bsZMCPlbek = "bsZMCPlbek",
zJueRCUwAo = "zJueRCUwAo",
ysCrfaicsB = "ysCrfaicsB",
PYFPoAnuey = "PYFPoAnuey",
ynPfztZuft = "ynPfztZuft",
uhdntsNGug = "uhdntsNGug",
TDtqZXCwPT = "TDtqZXCwPT",
NzIprxZHqj = "NzIprxZHqj",
JKrfKmYshN = "JKrfKmYshN",
UtVcivuwtn = "UtVcivuwtn",
jvePjrXhCW = "jvePjrXhCW",
einogTKoau = "einogTKoau",
tvuIVVQFMB = "tvuIVVQFMB",
DTaeslHdWO = "DTaeslHdWO",
MtJsEtMtvz = "MtJsEtMtvz",
OXweBUHOcm = "OXweBUHOcm",
nXLBjmtJBm = "nXLBjmtJBm",
gaFTKIGorC = "gaFTKIGorC",
udHWVrMLjl = "udHWVrMLjl",
wjyFnnSfll = "wjyFnnSfll",
AeSySoyvbA = "AeSySoyvbA",
gVXMbaDRkV = "gVXMbaDRkV",
QlfezMjujZ = "QlfezMjujZ",
ijCQIvtyNt = "ijCQIvtyNt",
gqhjUEDkQt = "gqhjUEDkQt",
kZSThpOQUB = "kZSThpOQUB",
ltTlHFLXkQ = "ltTlHFLXkQ",
gSoEwJJbIX = "gSoEwJJbIX",
pJrPekWfgU = "pJrPekWfgU",
igxRoqYrxy = "igxRoqYrxy",
yJnAdzBfIJ = "yJnAdzBfIJ",
ZLKjmeOdTl = "ZLKjmeOdTl",
bXfCNRjJfS = "bXfCNRjJfS",
altaLhXqTx = "altaLhXqTx",
AfZOFInsmK = "AfZOFInsmK",
eIgSReSkUt = "eIgSReSkUt",
CSvISlnrvb = "CSvISlnrvb",
YWrXxJsmcr = "YWrXxJsmcr",
depClpASrS = "depClpASrS",
iYlMVmpMJv = "iYlMVmpMJv",
xZEuieytns = "xZEuieytns",
tTcXeHeHhu = "tTcXeHeHhu",
ZHaaaxIjhJ = "ZHaaaxIjhJ",
FjWZEhSqMM = "FjWZEhSqMM",
vwedhGjuce = "vwedhGjuce",
IDhCttrLEU = "IDhCttrLEU",
ahXFreJlIJ = "ahXFreJlIJ",
MGBtCjceGF = "MGBtCjceGF",
OeRKVZSuZw = "OeRKVZSuZw",
gcWzjeSwlM = "gcWzjeSwlM",
TLQpDoqmbN = "TLQpDoqmbN",
JwcENOBTgz = "JwcENOBTgz",
WLmlephtXG = "WLmlephtXG",
yIVXyizqWG = "yIVXyizqWG",
eikwQrwteg = "eikwQrwteg",
vFuOwzFhVj = "vFuOwzFhVj",
ItsHBXgrXW = "ItsHBXgrXW",
OYutyylyuc = "OYutyylyuc",
WWzuJzxfZT = "WWzuJzxfZT",
pTRdtbkffv = "pTRdtbkffv",
VZBuVMoGBE = "VZBuVMoGBE",
wUiMCPCyxX = "wUiMCPCyxX",
nunsQTPbvW = "nunsQTPbvW",
feuBPUXAMM = "feuBPUXAMM",
tLZNzREOpM = "tLZNzREOpM",
PeFuEngZcX = "PeFuEngZcX",
wWGvfgMqEF = "wWGvfgMqEF",
vWWBTeHlDA = "vWWBTeHlDA",
WxCefqRmiw = "WxCefqRmiw",
OvYVkyxmOg = "OvYVkyxmOg",
sDgoNMJkxe = "sDgoNMJkxe",
RrYfUuAntr = "RrYfUuAntr",
bvfsJpjPQt = "bvfsJpjPQt",
UhnxrusSMr = "UhnxrusSMr",
yorlIYYurZ = "yorlIYYurZ",
ScrlWuAQXc = "ScrlWuAQXc",
rEFULuWaTX = "rEFULuWaTX",
izEtUsRuSu = "izEtUsRuSu",
CZZvjZEjDG = "CZZvjZEjDG",
MXUPmdlmjW = "MXUPmdlmjW",
wrNwNqvIeH = "wrNwNqvIeH",
iUFyBrpVOi = "iUFyBrpVOi",
eZtnDaMLUc = "eZtnDaMLUc",
ecAFPdcrRU = "ecAFPdcrRU",
WAVpqQertV = "WAVpqQertV",
IWcDArsjkF = "IWcDArsjkF",
SdrzkXOAoM = "SdrzkXOAoM",
pZlijFnMOX = "pZlijFnMOX",
UirXmtGiMR = "UirXmtGiMR",
InsHXOveid = "InsHXOveid",
igZrrTWuOw = "igZrrTWuOw",
lVgtvrAOGS = "lVgtvrAOGS",
ShLIULtvLy = "ShLIULtvLy",
dBGftwpqEC = "dBGftwpqEC",
OTceueXNkh = "OTceueXNkh",
JQQehOhxoB = "JQQehOhxoB",
fyzpmbNDUe = "fyzpmbNDUe",
sjvPratmiO = "sjvPratmiO",
KbGtgrzDIn = "KbGtgrzDIn",
LLhsuttlIl = "LLhsuttlIl",
FifduxBktE = "FifduxBktE",
sZAxPyetTc = "sZAxPyetTc",
egsahbmaMp = "egsahbmaMp",
HVAUwERFOH = "HVAUwERFOH",
BLKjwvYhyb = "BLKjwvYhyb",
ekeBinbYla = "ekeBinbYla",
mrbWpnZmMs = "mrbWpnZmMs",
rVxmwgedIz = "rVxmwgedIz",
rWLLpSiOvd = "rWLLpSiOvd",
fTcMDKFgfg = "fTcMDKFgfg",
OfrxwKItzV = "OfrxwKItzV",
YyzVRyjCvP = "YyzVRyjCvP",
fuqWtCAcNK = "fuqWtCAcNK",
SlnqurBFzn = "SlnqurBFzn",
bSGyYzRZgZ = "bSGyYzRZgZ",
kuARPipALD = "kuARPipALD",
mPewtRrGmM = "mPewtRrGmM",
krtejiizEJ = "krtejiizEJ",
gqcxfuNhhY = "gqcxfuNhhY",
xUBNAtRusV = "xUBNAtRusV",
wNtMQIMgwl = "wNtMQIMgwl",
NffrratHbg = "NffrratHbg",
hAxwOTZIbe = "hAxwOTZIbe",
iwVciZqsmw = "iwVciZqsmw",
KpSzrEGrMV = "KpSzrEGrMV",
jdtzPxmutj = "jdtzPxmutj",
JRHvUrJTeR = "JRHvUrJTeR",
rzoFcBkVFX = "rzoFcBkVFX",
TeDmhccYXI = "TeDmhccYXI",
MubrsqWmeJ = "MubrsqWmeJ",
QLMjzbflrX = "QLMjzbflrX",
bTxAYCEnGc = "bTxAYCEnGc",
sPMwhAAUtb = "sPMwhAAUtb",
suJmqlMpIh = "suJmqlMpIh",
xMwdapdsKV = "xMwdapdsKV",
uIzYHFZuuY = "uIzYHFZuuY",
HzuvwDiAfs = "HzuvwDiAfs",
LbHEZXYyRS = "LbHEZXYyRS",
tFfNsMtame = "tFfNsMtame",
YqtBdbeemH = "YqtBdbeemH",
aIQAJMQVIK = "aIQAJMQVIK",
vgjtiNGhwp = "vgjtiNGhwp",
JGNGyeWUxb = "JGNGyeWUxb",
qxunlXONZZ = "qxunlXONZZ",
coexpLpYwK = "coexpLpYwK",
ekSnsGtujz = "ekSnsGtujz",
LrpccXfTtw = "LrpccXfTtw",
OeXruKOSVs = "OeXruKOSVs",
WgQoXcywgO = "WgQoXcywgO",
DzeWicKLcb = "DzeWicKLcb",
ghEVPFyEeF = "ghEVPFyEeF",
NwyrRmceQl = "NwyrRmceQl",
BeDaOxQCyw = "BeDaOxQCyw",
mprTGngIhU = "mprTGngIhU",
prdkWPfepn = "prdkWPfepn",
MfeQjCEJkp = "MfeQjCEJkp",
JetxmdnLNb = "JetxmdnLNb",
ytewfjnpiY = "ytewfjnpiY",
AgkFTZaYLu = "AgkFTZaYLu",
BewoBrTVKw = "BewoBrTVKw",
GbCwfijuex = "GbCwfijuex",
ZrQmWMOEro = "ZrQmWMOEro",
lBzDjykIED = "lBzDjykIED",
iNnZIXcLeZ = "iNnZIXcLeZ",
WVLiCeSavQ = "WVLiCeSavQ",
ywFQcHbZcF = "ywFQcHbZcF",
GzbJwtDIJe = "GzbJwtDIJe",
OZzbfCeOWO = "OZzbfCeOWO",
FrVSGunruN = "FrVSGunruN",
qdrGcFuteT = "qdrGcFuteT",
lYlutFNurX = "lYlutFNurX",
dLVxMaYEqv = "dLVxMaYEqv",
jEivyhWdUZ = "jEivyhWdUZ",
gcpcuUtFlq = "gcpcuUtFlq",
EuKuSuCISx = "EuKuSuCISx",
xajLsDrjAq = "xajLsDrjAq",
yiOILKtMaQ = "yiOILKtMaQ",
ShUIIreuDM = "ShUIIreuDM",
ChCJllxHlQ = "ChCJllxHlQ",
gRyXugtRsG = "gRyXugtRsG",
YCbqThgQIA = "YCbqThgQIA",
WtxpxOThmD = "WtxpxOThmD",
CgreWCCLZh = "CgreWCCLZh",
DUYLZBMoox = "DUYLZBMoox",
CyZUuNUvWQ = "CyZUuNUvWQ",
JeLBERMfZF = "JeLBERMfZF",
tYojKXXCre = "tYojKXXCre",
kiNFtIJjgo = "kiNFtIJjgo",
xStieaeGNn = "xStieaeGNn",
RzGnfUlaci = "RzGnfUlaci",
jrSCVcghlw = "jrSCVcghlw",
LjXtZjVCIt = "LjXtZjVCIt",
YzHjbxuDKw = "YzHjbxuDKw",
zroUfeSxOd = "zroUfeSxOd",
JDUQQVmlwf = "JDUQQVmlwf",
hxbwduvGiu = "hxbwduvGiu",
hagCptkAFk = "hagCptkAFk",
yNtIAsgUev = "yNtIAsgUev",
taMnJKTcbz = "taMnJKTcbz",
urkIXarFit = "urkIXarFit",
etYwSezWdt = "etYwSezWdt",
KvnEZOeVzq = "KvnEZOeVzq",
rcvCxfiuVd = "rcvCxfiuVd",
jsrduUJLes = "jsrduUJLes",
soSNMrrobU = "soSNMrrobU",
auyeXcuxuS = "auyeXcuxuS",
eMUJdbdTBB = "eMUJdbdTBB",
oeGqztIScH = "oeGqztIScH",
IjeJFckFXo = "IjeJFckFXo",
XEIggFAVBq = "XEIggFAVBq",
KWNeGOuGOe = "KWNeGOuGOe",
buXSVxWgKP = "buXSVxWgKP",
vTWxYiekbr = "vTWxYiekbr",
cGvKXqBVep = "cGvKXqBVep",
izcyxzDoAB = "izcyxzDoAB",
bexAIGFxIn = "bexAIGFxIn",
TvRnpQRhVH = "TvRnpQRhVH",
dgWFNetwpa = "dgWFNetwpa",
wtoSFPyLaG = "wtoSFPyLaG",
andDeezxLm = "andDeezxLm",
qignrgrDuA = "qignrgrDuA",
tHeWVSMWrl = "tHeWVSMWrl",
QpFLVtjSrF = "QpFLVtjSrF",
hNajeXOlXI = "hNajeXOlXI",
qZWnTKhBmt = "qZWnTKhBmt",
hivscBxXFS = "hivscBxXFS",
loBUWbLECg = "loBUWbLECg",
IqvvvPiUJP = "IqvvvPiUJP",
izuHNpHYJy = "izuHNpHYJy",
pfLmOupLRL = "pfLmOupLRL",
VnECvVQeQS = "VnECvVQeQS",
TuFZxPrveG = "TuFZxPrveG",
KFpmpypvry = "KFpmpypvry",
FKvXOIPFgb = "FKvXOIPFgb",
mpWeqKXnnF = "mpWeqKXnnF",
ntaxtOChYl = "ntaxtOChYl",
FUPtxzkuuU = "FUPtxzkuuU",
KcPPNFzorw = "KcPPNFzorw",
YrWxheKwME = "YrWxheKwME",
WzoLLrjpzm = "WzoLLrjpzm",
wBspCFyApZ = "wBspCFyApZ",
LPyObPYNtI = "LPyObPYNtI",
uZEeylnLpR = "uZEeylnLpR",
ARUgxtHSWE = "ARUgxtHSWE",
rFgAvtSLru = "rFgAvtSLru",
zycxwTrWXm = "zycxwTrWXm",
rlkPshxvAC = "rlkPshxvAC",
CGdXvjeHoW = "CGdXvjeHoW",
WTwVeHkqSz = "WTwVeHkqSz",
BejSlxCdBG = "BejSlxCdBG",
SJoTluwCjA = "SJoTluwCjA",
rueLTuftdO = "rueLTuftdO",
PIherYAbQh = "PIherYAbQh",
ZNGDqNMDeL = "ZNGDqNMDeL",
rabwWpuUAb = "rabwWpuUAb",
nIQHdOZLJj = "nIQHdOZLJj",
tcRrboyXBn = "tcRrboyXBn",
oQxZwQStSU = "oQxZwQStSU",
UGHymLkZrO = "UGHymLkZrO",
DcxrkVAVHr = "DcxrkVAVHr",
CTjwkuMbPC = "CTjwkuMbPC",
NXkKHpjGht = "NXkKHpjGht",
XLnULYGMAu = "XLnULYGMAu",
tYbvEzfMIr = "tYbvEzfMIr",
QIykjupWRe = "QIykjupWRe",
eNtuJsffTa = "eNtuJsffTa",
WPQNfLeLNy = "WPQNfLeLNy",
tNnKzPfuNa = "tNnKzPfuNa",
krpXyNFAJR = "krpXyNFAJR",
rlUUujrIAL = "rlUUujrIAL",
HgNiKRRYto = "HgNiKRRYto",
IjBEerHQaH = "IjBEerHQaH",
MvHkriErFP = "MvHkriErFP",
dlHxVjFCvQ = "dlHxVjFCvQ",
LbTjrditBb = "LbTjrditBb",
BRZZjQIgcQ = "BRZZjQIgcQ",
DMdqLYVAse = "DMdqLYVAse",
tfVecACtIo = "tfVecACtIo",
oWwkpxNEOq = "oWwkpxNEOq",
EvoFgVaxHX = "EvoFgVaxHX",
pPdqCbbteJ = "pPdqCbbteJ",
ovRHQgHhYe = "ovRHQgHhYe",
TBxLNkgODK = "TBxLNkgODK",
adtvdulerz = "adtvdulerz",
gLCGQNYcbU = "gLCGQNYcbU",
weGLTUIKbm = "weGLTUIKbm",
NBkUuDOnEg = "NBkUuDOnEg",
FEghvidgkS = "FEghvidgkS",
rXcTLKnQmK = "rXcTLKnQmK",
OsXsdOgIuL = "OsXsdOgIuL",
bAipctAqSs = "bAipctAqSs",
pmwDqzdcAf = "pmwDqzdcAf",
ETEQTSbtbf = "ETEQTSbtbf",
mqPrPVMOPs = "mqPrPVMOPs",
jNqkbPHdFU = "jNqkbPHdFU",
uMotGyMjsS = "uMotGyMjsS",
WmcsznDgyf = "WmcsznDgyf",
chkYDruDsl = "chkYDruDsl",
OpnrLxEtpO = "OpnrLxEtpO",
AzWrpLJYFW = "AzWrpLJYFW",
ArwujBWiQE = "ArwujBWiQE",
dDpQwhyFfO = "dDpQwhyFfO",
WQugQaHUQX = "WQugQaHUQX",
LDwgiauUtv = "LDwgiauUtv",
irwYeRYxkk = "irwYeRYxkk",
HGnEqSmXUQ = "HGnEqSmXUQ",
ajHJeeMvYb = "ajHJeeMvYb",
gTRkVxhVkk = "gTRkVxhVkk",
QWoWhbChqv = "QWoWhbChqv",
rhiMszIlqN = "rhiMszIlqN",
MjGjwrfyNu = "MjGjwrfyNu",
YicclVeZxs = "YicclVeZxs",
ScEkqnDcay = "ScEkqnDcay",
BnqTIvrNeJ = "BnqTIvrNeJ",
vatwkDosuO = "vatwkDosuO",
eSetDqnBRW = "eSetDqnBRW",
PtBbwdWgmb = "PtBbwdWgmb",
vKxWHuDdQo = "vKxWHuDdQo",
WbZYQrzreK = "WbZYQrzreK",
xwkPZtTrcz = "xwkPZtTrcz",
OwFPXYpPtf = "OwFPXYpPtf",
RJRpAtrSHe = "RJRpAtrSHe",
RHdUOQSBzY = "RHdUOQSBzY",
wJfXhVCMaY = "wJfXhVCMaY",
NMqBxggFNS = "NMqBxggFNS",
jZxrFquQrF = "jZxrFquQrF",
BtOoaXbOiW = "BtOoaXbOiW",
MtaommNkCp = "MtaommNkCp",
dvpOskeJHE = "dvpOskeJHE",
BnxKIfxrKm = "BnxKIfxrKm",
eQorMklSTx = "eQorMklSTx",
KOAEZVAwxj = "KOAEZVAwxj",
FphqQTiSwZ = "FphqQTiSwZ",
NXynJdLXrY = "NXynJdLXrY",
HEtVIiDwuo = "HEtVIiDwuo",
ukrvMlTywG = "ukrvMlTywG",
eGAeHjeJax = "eGAeHjeJax",
kZtCNIZpYY = "kZtCNIZpYY",
otqjsIkdrT = "otqjsIkdrT",
mVMuldQZQt = "mVMuldQZQt",
qdoeJTccpc = "qdoeJTccpc",
uzsjefCreQ = "uzsjefCreQ",
MaveFrnTBB = "MaveFrnTBB",
cpLfSqBdZo = "cpLfSqBdZo",
EpeuJWztCB = "EpeuJWztCB",
NNBOmpfqgp = "NNBOmpfqgp",
tYmPADkwsZ = "tYmPADkwsZ",
IrBvCceAOS = "IrBvCceAOS",
xuQHUrTMug = "xuQHUrTMug",
FeWCPYryuk = "FeWCPYryuk",
YeSPayIzeu = "YeSPayIzeu",
fwxTrKwuDM = "fwxTrKwuDM",
KCHuJqMHqZ = "KCHuJqMHqZ",
hKOctXgSDt = "hKOctXgSDt",
lEUxSwiGCM = "lEUxSwiGCM",
sXvOzrLYVu = "sXvOzrLYVu",
jJQPycznhu = "jJQPycznhu",
hNPYbeTNTy = "hNPYbeTNTy",
JZYLtetiWm = "JZYLtetiWm",
ItiEULdqYs = "ItiEULdqYs",
YnVNWeskjO = "YnVNWeskjO",
cxToZLsAPq = "cxToZLsAPq",
rCyDOWETRn = "rCyDOWETRn",
YsXwuAupQL = "YsXwuAupQL",
uyfdUixBwQ = "uyfdUixBwQ",
fvHUPwEZnt = "fvHUPwEZnt",
CeTQmfGtub = "CeTQmfGtub",
oHSBbDyTlb = "oHSBbDyTlb",
TpNSWNrPbh = "TpNSWNrPbh",
waqIHKjEux = "waqIHKjEux",
OhffuwOYjJ = "OhffuwOYjJ",
LgdcgIbelx = "LgdcgIbelx",
LruKEkjZIM = "LruKEkjZIM",
zaOAtDQzPt = "zaOAtDQzPt",
nslcBFjyAg = "nslcBFjyAg",
rjnJldZTBX = "rjnJldZTBX",
HUQafmrRuU = "HUQafmrRuU",
dvKqdFnxYo = "dvKqdFnxYo",
bXtiHrzBOv = "bXtiHrzBOv",
kNRTtjvJss = "kNRTtjvJss",
gNMxzzPkoH = "gNMxzzPkoH",
eABtLQeEcc = "eABtLQeEcc",
vqYUjOtdge = "vqYUjOtdge",
urtFSSTSfa = "urtFSSTSfa",
HudQVHqXbU = "HudQVHqXbU",
notomrFXuQ = "notomrFXuQ",
HROjtBVhQr = "HROjtBVhQr",
jVmSBVpNVk = "jVmSBVpNVk",
UmqhusbVZi = "UmqhusbVZi",
ikrKtMKISE = "ikrKtMKISE",
IlVNyXJIfu = "IlVNyXJIfu",
pvnFbOzqDB = "pvnFbOzqDB",
euEotPfckB = "euEotPfckB",
rEskBHXotX = "rEskBHXotX",
eoWVuBqRXu = "eoWVuBqRXu",
OttRstyccA = "OttRstyccA",
xeHjPzGFDX = "xeHjPzGFDX",
eXnCrEVUTt = "eXnCrEVUTt",
umMWDNEPXI = "umMWDNEPXI",
aVuBWEVBtT = "aVuBWEVBtT",
zefdlXXAzz = "zefdlXXAzz",
pFaEtLfYJr = "pFaEtLfYJr",
ZgnDtoEcnY = "ZgnDtoEcnY",
yAcnfVmeSA = "yAcnfVmeSA",
QXotFnCOTB = "QXotFnCOTB",
thWyfztQLN = "thWyfztQLN",
sdIwvitnIp = "sdIwvitnIp",
VgIkRjQqsw = "VgIkRjQqsw",
nqbZHhqfKx = "nqbZHhqfKx",
vNkkdWDXzs = "vNkkdWDXzs",
CRooetpDlI = "CRooetpDlI",
DdyMXuiixY = "DdyMXuiixY",
LXltuctzNd = "LXltuctzNd",
AbyBosueDt = "AbyBosueDt",
ouafqzPwOK = "ouafqzPwOK",
CaoeXGvUQs = "CaoeXGvUQs",
SlrTONcUUH = "SlrTONcUUH",
nYDVUrUrud = "nYDVUrUrud",
NOhtrVIeIT = "NOhtrVIeIT",
xUiQnSGiFT = "xUiQnSGiFT",
tibJqXenpT = "tibJqXenpT",
xsRjEtRqem = "xsRjEtRqem",
zsfkkVWOHe = "zsfkkVWOHe",
cbsAuGpUwp = "cbsAuGpUwp",
OQbVCoFYEY = "OQbVCoFYEY",
nmNfqVLaOQ = "nmNfqVLaOQ",
ftluatkvtu = "ftluatkvtu",
ehdkuQGoPu = "ehdkuQGoPu",
yeeIQijimk = "yeeIQijimk",
mATvPrArMr = "mATvPrArMr",
euBnixwrry = "euBnixwrry",
ItuVssteDr = "ItuVssteDr",
CTfpgPkhwk = "CTfpgPkhwk",
WCNVNCsZKz = "WCNVNCsZKz",
HxJuUSwGuM = "HxJuUSwGuM",
epTNeNtyfW = "epTNeNtyfW",
pylOTKGTgZ = "pylOTKGTgZ",
yYuqBgSBrx = "yYuqBgSBrx",
KpCBwDloeE = "KpCBwDloeE",
cuwtQleTVF = "cuwtQleTVF",
uyYXgxXVAw = "uyYXgxXVAw",
xEOItHICgB = "xEOItHICgB",
MztReeEEDk = "MztReeEEDk",
VHAzDVJLPw = "VHAzDVJLPw",
exsIyXLbpp = "exsIyXLbpp",
vgChguLZjg = "vgChguLZjg",
DLUtpWthCu = "DLUtpWthCu",
kwMAfLifZX = "kwMAfLifZX",
DOsVKgBmrF = "DOsVKgBmrF",
mtMXSHDuUj = "mtMXSHDuUj",
TzeJBCBckS = "TzeJBCBckS",
ttplBaSpPh = "ttplBaSpPh",
OuHxUZkVpU = "OuHxUZkVpU",
UTnMBAzquE = "UTnMBAzquE",
yOsNpuFjvG = "yOsNpuFjvG",
zsLEFPgalo = "zsLEFPgalo",
ThMCtNZJIR = "ThMCtNZJIR",
kpMBNNaSRj = "kpMBNNaSRj",
sbLrJeEUMa = "sbLrJeEUMa",
eVLqDmYEem = "eVLqDmYEem",
DqHzPbANEy = "DqHzPbANEy",
JVhjhIXIBg = "JVhjhIXIBg",
TOslFszmQe = "TOslFszmQe",
TtVDyRXXpW = "TtVDyRXXpW",
BTXGPcKHGs = "BTXGPcKHGs",
MJgfVwuPrv = "MJgfVwuPrv",
IxutovxPAu = "IxutovxPAu",
RVEQezteqp = "RVEQezteqp",
WLzKwUzAOe = "WLzKwUzAOe",
lxgugYheep = "lxgugYheep",
ZSuuyCjdiH = "ZSuuyCjdiH",
sycSrUjuNE = "sycSrUjuNE",
IJpuzQhfEe = "IJpuzQhfEe",
uktyWBTsuk = "uktyWBTsuk",
MGFDnmBstt = "MGFDnmBstt",
MCuRatTJMi = "MCuRatTJMi",
zIUfledapN = "zIUfledapN",
xRScZwYfaF = "xRScZwYfaF",
GIOyUtOLrf = "GIOyUtOLrf",
tmFXTXLaqt = "tmFXTXLaqt",
SEdbfjoqUr = "SEdbfjoqUr",
gGAtXftOck = "gGAtXftOck",
vdHkHXPudk = "vdHkHXPudk",
grjPzafWdU = "grjPzafWdU",
EQtxuebtzu = "EQtxuebtzu",
kYTTiISHeJ = "kYTTiISHeJ",
nPkjzksIul = "nPkjzksIul",
DserucGdWz = "DserucGdWz",
KDUppyEBEm = "KDUppyEBEm",
KtyrlFwoqx = "KtyrlFwoqx",
HBkwLkfreT = "HBkwLkfreT",
ddeGAEBLQP = "ddeGAEBLQP",
NmqrLgFcQf = "NmqrLgFcQf",
qxLISTMzuA = "qxLISTMzuA",
RIfkaizZZr = "RIfkaizZZr",
DNTlskfPkO = "DNTlskfPkO",
XhQlMveKvW = "XhQlMveKvW",
wxeRweCpTs = "wxeRweCpTs",
vplweupQXA = "vplweupQXA",
VZevtkwsfv = "VZevtkwsfv",
cxBGXDYibe = "cxBGXDYibe",
OWgnIpeLuy = "OWgnIpeLuy",
VtEvWvQkiF = "VtEvWvQkiF",
aDNLcBcuYp = "aDNLcBcuYp",
SaVhyKicsO = "SaVhyKicsO",
QiyvcNVeLn = "QiyvcNVeLn",
liGjVPsQGT = "liGjVPsQGT",
umMqXLStyy = "umMqXLStyy",
Zervabucjo = "Zervabucjo",
LrzTWmuoMv = "LrzTWmuoMv",
yWnrmermRN = "yWnrmermRN",
XrJetrGcIj = "XrJetrGcIj",
GHEdscPDkN = "GHEdscPDkN",
eLpuJgNjax = "eLpuJgNjax",
wQtehyeHOn = "wQtehyeHOn",
VMwKleAuaE = "VMwKleAuaE",
OaQsVXEuWw = "OaQsVXEuWw",
txYvDqBbuh = "txYvDqBbuh",
shfwTeaqyH = "shfwTeaqyH",
AErBundZkO = "AErBundZkO",
dtnTREUZHX = "dtnTREUZHX",
rVNvKGLGWw = "rVNvKGLGWw",
QQToBkbdet = "QQToBkbdet",
epHeOQigki = "epHeOQigki",
kvXgFFPUau = "kvXgFFPUau",
rDowlkfYuM = "rDowlkfYuM",
QQOatzNTej = "QQOatzNTej",
REozjuokLG = "REozjuokLG",
QuOxXDyXdR = "QuOxXDyXdR",
BrYtHutfOO = "BrYtHutfOO",
lmPnDkbTCD = "lmPnDkbTCD",
CorInEAKCZ = "CorInEAKCZ",
kldmuISUzH = "kldmuISUzH",
dovgBUNZNa = "dovgBUNZNa",
wstZGvSgwH = "wstZGvSgwH",
RmeZyeOrmv = "RmeZyeOrmv",
SozQzjmnvt = "SozQzjmnvt",
UUeUShXeJp = "UUeUShXeJp",
TwjGnrjboU = "TwjGnrjboU",
nhXiACqHjk = "nhXiACqHjk",
nowHKowemx = "nowHKowemx",
wrZtFrqRSd = "wrZtFrqRSd",
uTxhEfEfZv = "uTxhEfEfZv",
uzbehWurzO = "uzbehWurzO",
pJDglukPas = "pJDglukPas",
duBiwMYsFO = "duBiwMYsFO",
rDjOydQhuU = "rDjOydQhuU",
RhKHHorYbR = "RhKHHorYbR",
tchElhZLHk = "tchElhZLHk",
PQJyMtnqsl = "PQJyMtnqsl",
dzQerhptgV = "dzQerhptgV",
SAfUttuwFs = "SAfUttuwFs",
ZIfHFxFYxD = "ZIfHFxFYxD",
IkyRaEpWle = "IkyRaEpWle",
AUdDfwOntP = "AUdDfwOntP",
GgaXFaYniP = "GgaXFaYniP",
qYrXnmbJzE = "qYrXnmbJzE",
JLceLkvuoB = "JLceLkvuoB",
zwCGEgCJFV = "zwCGEgCJFV",
QRehrOezWD = "QRehrOezWD",
vynbkVlbWm = "vynbkVlbWm",
LlsHaeehdB = "LlsHaeehdB",
RfjKGEAusN = "RfjKGEAusN",
xFlMgLddxJ = "xFlMgLddxJ",
xSwBZeccZa = "xSwBZeccZa",
ICXPigTAyi = "ICXPigTAyi",
llagjrtnxR = "llagjrtnxR",
yJoGsvNtvp = "yJoGsvNtvp",
LnBlfIbqnt = "LnBlfIbqnt",
TuKXGYcUvL = "TuKXGYcUvL",
TSdFDRSlbJ = "TSdFDRSlbJ",
yDuUgRrStQ = "yDuUgRrStQ",
XLpuvekCqu = "XLpuvekCqu",
QVJxuuBaQh = "QVJxuuBaQh",
rysvVOWLSf = "rysvVOWLSf",
qtruoRBrCf = "qtruoRBrCf",
ajUugJTQoV = "ajUugJTQoV",
vMaFyvDxeO = "vMaFyvDxeO",
VoqVRmpteK = "VoqVRmpteK",
thuyawAsDe = "thuyawAsDe",
EmcKBjWWGo = "EmcKBjWWGo",
nHvVjPrPsC = "nHvVjPrPsC",
xWStFbEIbm = "xWStFbEIbm",
PvExPnzjxe = "PvExPnzjxe",
VYOeRJpaIR = "VYOeRJpaIR",
ZzIuyeYUic = "ZzIuyeYUic",
amepuTPljp = "amepuTPljp",
KqMcGYkzyc = "KqMcGYkzyc",
pfWstOBhVk = "pfWstOBhVk",
ipNStokyDX = "ipNStokyDX",
okLtKEWxxn = "okLtKEWxxn",
tduhEBoEHq = "tduhEBoEHq",
WuPUEcegtK = "WuPUEcegtK",
currZbfnhm = "currZbfnhm",
IhVYEsNeyf = "IhVYEsNeyf",
oxTYBtSEvb = "oxTYBtSEvb",
YiKAauCEtb = "YiKAauCEtb",
erTTCfhthl = "erTTCfhthl",
PyZvFHxkrJ = "PyZvFHxkrJ",
ksqgbgePux = "ksqgbgePux",
zPYULUTWMt = "zPYULUTWMt",
iqrDKkEgXF = "iqrDKkEgXF",
ssSOmdrOGx = "ssSOmdrOGx",
PTsmCCZUjb = "PTsmCCZUjb",
gqNdtKWMXV = "gqNdtKWMXV",
rpKpsuMSie = "rpKpsuMSie",
agQaiqetrv = "agQaiqetrv",
CvWCGGkGrx = "CvWCGGkGrx",
ANrbunmhgu = "ANrbunmhgu",
mwAhnXrtiK = "mwAhnXrtiK",
kulergnBwM = "kulergnBwM",
aNrtGwIdQw = "aNrtGwIdQw",
SwhwjtCGpz = "SwhwjtCGpz",
aHpXeZnBGB = "aHpXeZnBGB",
YnobMcENar = "YnobMcENar",
YiubKbupwe = "YiubKbupwe",
dLkUnxsAmz = "dLkUnxsAmz",
RQuMCAYvlT = "RQuMCAYvlT",
sqJknyVudl = "sqJknyVudl",
DGmuhAuFmG = "DGmuhAuFmG",
iNDMvCLtre = "iNDMvCLtre",
zUKSNQQrve = "zUKSNQQrve",
wwuiuSghFp = "wwuiuSghFp",
wJdgkaeOrD = "wJdgkaeOrD",
bqzXfeVeEM = "bqzXfeVeEM",
LPbkjtcdxe = "LPbkjtcdxe",
pVIQTThMSK = "pVIQTThMSK",
AcnDgCfWjT = "AcnDgCfWjT",
VfrcACtYQT = "VfrcACtYQT",
oqzwaIeVSx = "oqzwaIeVSx",
pAqNieaeqo = "pAqNieaeqo",
afpidrWyuO = "afpidrWyuO",
UOJTNusPtj = "UOJTNusPtj",
OfIwmfTpRs = "OfIwmfTpRs",
aRFcqtHHKX = "aRFcqtHHKX",
rLjBTewdTG = "rLjBTewdTG",
aWVlKytCmj = "aWVlKytCmj",
GRbsPQAJRe = "GRbsPQAJRe",
eRnKzxFhyo = "eRnKzxFhyo",
teqSZNHgLE = "teqSZNHgLE",
DxRhGsFlBi = "DxRhGsFlBi",
iyCgDbrqvt = "iyCgDbrqvt",
ZNPIITLtAf = "ZNPIITLtAf",
UIdYxQHGKD = "UIdYxQHGKD",
lxFMqhezEa = "lxFMqhezEa",
GPrQvqrvJB = "GPrQvqrvJB",
YFeXhDXGXr = "YFeXhDXGXr",
mXqVfTuUvp = "mXqVfTuUvp",
ImrpnjJPLf = "ImrpnjJPLf",
haqOTqctgN = "haqOTqctgN",
ArwcMGznQM = "ArwcMGznQM",
VPtIipaxow = "VPtIipaxow",
dWjDOdooKi = "dWjDOdooKi",
CmfgkYJqLM = "CmfgkYJqLM",
ajiyHcadBh = "ajiyHcadBh",
rRKdvxBfSp = "rRKdvxBfSp",
ggRpsAAMvK = "ggRpsAAMvK",
xquYrMgORp = "xquYrMgORp",
ufUNntbzrL = "ufUNntbzrL",
FidlYjKVcW = "FidlYjKVcW",
tUdGOFYoeX = "tUdGOFYoeX",
dbWMoFeiwN = "dbWMoFeiwN",
dTYPeYSpXt = "dTYPeYSpXt",
kgoizifCEl = "kgoizifCEl",
uJGznvyHCI = "uJGznvyHCI",
oeZzmIrPsw = "oeZzmIrPsw",
nzXDFLWwCt = "nzXDFLWwCt",
uALjSarSHD = "uALjSarSHD",
btFjuPpwQZ = "btFjuPpwQZ",
gyxFzsnNeY = "gyxFzsnNeY",
fYFYOwRtCP = "fYFYOwRtCP",
fBodByTaKF = "fBodByTaKF",
zDfSFfevYy = "zDfSFfevYy",
vNWAQQXNcE = "vNWAQQXNcE",
SutZPgRhFh = "SutZPgRhFh",
cCRXiUNeMU = "cCRXiUNeMU",
RssvjpIcEM = "RssvjpIcEM",
BqqfRrvdDE = "BqqfRrvdDE",
BhUwuIbTgx = "BhUwuIbTgx",
cEtykWOOBM = "cEtykWOOBM",
gKDbbNyICB = "gKDbbNyICB",
PeIdsDKNvy = "PeIdsDKNvy",
VckPypViLk = "VckPypViLk",
VngzEkCfzh = "VngzEkCfzh",
kbYmYNHQGv = "kbYmYNHQGv",
HDTeJqjlPu = "HDTeJqjlPu",
dbVrlEFfuH = "dbVrlEFfuH",
rDTZPNmyer = "rDTZPNmyer",
hnOPqDLouJ = "hnOPqDLouJ",
wuUuClIruf = "wuUuClIruf",
zoVfTJXxfs = "zoVfTJXxfs",
lIhMcrTxkb = "lIhMcrTxkb",
PnMtriDWub = "PnMtriDWub",
tLJvgOjYQR = "tLJvgOjYQR",
txtYENMQAg = "txtYENMQAg",
dnLZrpEJWT = "dnLZrpEJWT",
tukKwszrUV = "tukKwszrUV",
fIdqqWYpYK = "fIdqqWYpYK",
cuQqJBAtSD = "cuQqJBAtSD",
cVkrBtFunS = "cVkrBtFunS",
FytGrEoqEN = "FytGrEoqEN",
tarrqWYzGK = "tarrqWYzGK",
MTqfREPvjt = "MTqfREPvjt",
SWjAZgxPcQ = "SWjAZgxPcQ",
RfeIQyFguM = "RfeIQyFguM",
nopVrZuIDn = "nopVrZuIDn",
ygEjVRRKiS = "ygEjVRRKiS",
iLToPYjtsZ = "iLToPYjtsZ",
jGbmNAxots = "jGbmNAxots",
JOFyAqPfcq = "JOFyAqPfcq",
uwTLtthGNv = "uwTLtthGNv",
aivIRmGSiR = "aivIRmGSiR",
AJItthampY = "AJItthampY",
DeczeqXIiu = "DeczeqXIiu",
rmznzPrKIW = "rmznzPrKIW",
peYnWIoceh = "peYnWIoceh",
iOLxXtmITy = "iOLxXtmITy",
PtsjKLGtuD = "PtsjKLGtuD",
HZIIpTFFBx = "HZIIpTFFBx",
lRRXowzqQr = "lRRXowzqQr",
sUiKwDXomM = "sUiKwDXomM",
htJVSymSDE = "htJVSymSDE",
YIftvYGhey = "YIftvYGhey",
djIkgEATKr = "djIkgEATKr",
DbtyjpMKaC = "DbtyjpMKaC",
VtsLMNEteu = "VtsLMNEteu",
jpgrFGsaSp = "jpgrFGsaSp",
SXroKMCCVt = "SXroKMCCVt",
gTgnIGjBvS = "gTgnIGjBvS",
ewetLedlrt = "ewetLedlrt",
ePDyPVMGwh = "ePDyPVMGwh",
WnIGYQnBFm = "WnIGYQnBFm",
SuFUcrjQsf = "SuFUcrjQsf",
wleapAwEkv = "wleapAwEkv",
kIGnODQtmt = "kIGnODQtmt",
zmKNtQAeRQ = "zmKNtQAeRQ",
CLaEzSldmw = "CLaEzSldmw",
quXRPDgPMp = "quXRPDgPMp",
ayYYzpKmVt = "ayYYzpKmVt",
LJUzDsiHoA = "LJUzDsiHoA",
kefbvdBCAl = "kefbvdBCAl",
stuphtttGn = "stuphtttGn",
qhVJVhukkQ = "qhVJVhukkQ",
tKBLPHMFWK = "tKBLPHMFWK",
tcsTzWgIZP = "tcsTzWgIZP",
ydwrRNDdtx = "ydwrRNDdtx",
diFuRjXBrr = "diFuRjXBrr",
MRPscCyKva = "MRPscCyKva",
akIgjhZfSg = "akIgjhZfSg",
lSKArQVYGr = "lSKArQVYGr",
AlZbzLJGyt = "AlZbzLJGyt",
VrbBvgGcPe = "VrbBvgGcPe",
hopHOeHBMT = "hopHOeHBMT",
QgLTIskkun = "QgLTIskkun",
QNJAHktgxw = "QNJAHktgxw",
tXJcVuDvBt = "tXJcVuDvBt",
VFIeDuvTro = "VFIeDuvTro",
EgrVtesLXA = "EgrVtesLXA",
pdtaWFiAGI = "pdtaWFiAGI",
qArHQyqdHr = "qArHQyqdHr",
eHYzoxwYPf = "eHYzoxwYPf",
zwvgZdCfHQ = "zwvgZdCfHQ",
OsgEQOAeAp = "OsgEQOAeAp",
wdpHkjGcTp = "wdpHkjGcTp",
FSxJVyeSBZ = "FSxJVyeSBZ",
FwurFabhTj = "FwurFabhTj",
AyjoiSQFIe = "AyjoiSQFIe",
ThNrCCOCpW = "ThNrCCOCpW",
oqiMwkhicd = "oqiMwkhicd",
OGMleYgtDi = "OGMleYgtDi",
KurGumyxWQ = "KurGumyxWQ",
NOJjvxWBVt = "NOJjvxWBVt",
YfZMaBblPC = "YfZMaBblPC",
JtiIjzNSjy = "JtiIjzNSjy",
wEmuHouRUO = "wEmuHouRUO",
MqnsRHCWJN = "MqnsRHCWJN",
ISzWKErtYU = "ISzWKErtYU",
uSOyetxzrE = "uSOyetxzrE",
BkeUrePpAg = "BkeUrePpAg",
vyHjbddWrl = "vyHjbddWrl",
tvTSwwHHbK = "tvTSwwHHbK",
xAIRqBjwAb = "xAIRqBjwAb",
VqwyyvrblU = "VqwyyvrblU",
xnVIruVQXe = "xnVIruVQXe",
RoocinmEDn = "RoocinmEDn",
uBctUFrfpF = "uBctUFrfpF",
eNkXmtLSFp = "eNkXmtLSFp",
UBTWpCDJZY = "UBTWpCDJZY",
ZrnetesZcg = "ZrnetesZcg",
WScnmdrOfZ = "WScnmdrOfZ",
zoeTUhEEKd = "zoeTUhEEKd",
hzYGpSUZUA = "hzYGpSUZUA",
EsnRiUcByl = "EsnRiUcByl",
LzatbeliNt = "LzatbeliNt",
pADzcxovsL = "pADzcxovsL",
adOZYGFhCm = "adOZYGFhCm",
oVqWQKnuqY = "oVqWQKnuqY",
DKjIGdjPDe = "DKjIGdjPDe",
uPvQnopNuN = "uPvQnopNuN",
tUJgvhGAnO = "tUJgvhGAnO",
FVLhSPEucn = "FVLhSPEucn",
NjQJAxnqNq = "NjQJAxnqNq",
hjymrJlVbC = "hjymrJlVbC",
miJFOLajUJ = "miJFOLajUJ",
fsFrTikDcX = "fsFrTikDcX",
vVPPgOEtHF = "vVPPgOEtHF",
DVtHWpwaFo = "DVtHWpwaFo",
FoZvjSLuUv = "FoZvjSLuUv",
RBnenMuhyb = "RBnenMuhyb",
cNBKVitztB = "cNBKVitztB",
kiJGZhNkjZ = "kiJGZhNkjZ",
uEIYQCbVNk = "uEIYQCbVNk",
otgSvLahKC = "otgSvLahKC",
UpPyeuVKGG = "UpPyeuVKGG",
SyghQCAbmd = "SyghQCAbmd",
WBivsrGhkg = "WBivsrGhkg",
sAdFMnTCIq = "sAdFMnTCIq",
eCeuztYNuJ = "eCeuztYNuJ",
TXtssUXvpO = "TXtssUXvpO",
zsEKGbqrsm = "zsEKGbqrsm",
JPcDbIyeQZ = "JPcDbIyeQZ",
bXoKBQlNBl = "bXoKBQlNBl",
OgfjHyUGfz = "OgfjHyUGfz",
BWLzLosWBi = "BWLzLosWBi",
plHYQzTuXT = "plHYQzTuXT",
pfzvZkhHfS = "pfzvZkhHfS",
CPIeEfrlNx = "CPIeEfrlNx",
bUTkWAYOzh = "bUTkWAYOzh",
xZMXXKPOIt = "xZMXXKPOIt",
POrJvGfrdV = "POrJvGfrdV",
HeZGjUEmHo = "HeZGjUEmHo",
WjdVPElUnw = "WjdVPElUnw",
rteQLMUqrt = "rteQLMUqrt",
IehLbAwziK = "IehLbAwziK",
NvzMBCtrGx = "NvzMBCtrGx",
egeCMycQzD = "egeCMycQzD",
jUoZxsYBPh = "jUoZxsYBPh",
LgrCKcdEDh = "LgrCKcdEDh",
rcnkgHYULV = "rcnkgHYULV",
CJTVnJPbvQ = "CJTVnJPbvQ",
HEyTBROyrB = "HEyTBROyrB",
ueZyITsXBR = "ueZyITsXBR",
kDSGfuYZKq = "kDSGfuYZKq",
sInLSKPtlu = "sInLSKPtlu",
wlOLePtyEe = "wlOLePtyEe",
qOplleIJxV = "qOplleIJxV",
AtVVcVLZqe = "AtVVcVLZqe",
dJmHzKaCXk = "dJmHzKaCXk",
uXrudaNPFv = "uXrudaNPFv",
eZnIlpdHBY = "eZnIlpdHBY",
pCrXPOuxJd = "pCrXPOuxJd",
knquFfdqxC = "knquFfdqxC",
UzAMtIIgCF = "UzAMtIIgCF",
qselhZcteL = "qselhZcteL",
vcJkyXyytY = "vcJkyXyytY",
ZpxYDORyXd = "ZpxYDORyXd",
jYQhucmWYd = "jYQhucmWYd",
nbbTFAIAwT = "nbbTFAIAwT",
uvEbMtEgea = "uvEbMtEgea",
ndXjPCQVfk = "ndXjPCQVfk",
tSBSKZLHJx = "tSBSKZLHJx",
iZcSDhWtpB = "iZcSDhWtpB",
HGCIymKCAe = "HGCIymKCAe",
Jkjtgydonx = "Jkjtgydonx",
rijFVzIIie = "rijFVzIIie",
GfEOIqsevY = "GfEOIqsevY",
gpHEqkWjBO = "gpHEqkWjBO",
GlosTzLVbo = "GlosTzLVbo",
XYhoOHWlfu = "XYhoOHWlfu",
xEjnmVBStr = "xEjnmVBStr",
LGSGeJDGmy = "LGSGeJDGmy",
bIjTBuAagr = "bIjTBuAagr",
KDPggvVzdG = "KDPggvVzdG",
VuUuIDnvqa = "VuUuIDnvqa",
Bpgkbeocff = "Bpgkbeocff",
RfYsxtrCst = "RfYsxtrCst",
naPpSnloNX = "naPpSnloNX",
qYJUEgneaS = "qYJUEgneaS",
PgEjHVwmCa = "PgEjHVwmCa",
rZGiYjPIZr = "rZGiYjPIZr",
VlaQemLade = "VlaQemLade",
sJGkvRcuhI = "sJGkvRcuhI",
hgZkXxmiza = "hgZkXxmiza",
QExYmCLoty = "QExYmCLoty",
gTAMeFGwWn = "gTAMeFGwWn",
dtqgskSdEp = "dtqgskSdEp",
AOgZzqNhHC = "AOgZzqNhHC",
rFzxcmpVHK = "rFzxcmpVHK",
pmeZKBrkBh = "pmeZKBrkBh",
MiVdTjeZKZ = "MiVdTjeZKZ",
HRyTfJajYb = "HRyTfJajYb",
ywayseUunI = "ywayseUunI",
nuhgZRHnRo = "nuhgZRHnRo",
erVHTyOumb = "erVHTyOumb",
EdYvuxsvss = "EdYvuxsvss",
cYPSzWotPw = "cYPSzWotPw",
YgaFgueWdZ = "YgaFgueWdZ",
xVGgeqcItr = "xVGgeqcItr",
dEyjbaXXTl = "dEyjbaXXTl",
jurdMhuLor = "jurdMhuLor",
TvVYtLzoGr = "TvVYtLzoGr",
enbitCfGbl = "enbitCfGbl",
zSkSCBYNuj = "zSkSCBYNuj",
bRrhpKoNys = "bRrhpKoNys",
yRtmeQbfTN = "yRtmeQbfTN",
MunLEFIkNQ = "MunLEFIkNQ",
dnuVLTZxUK = "dnuVLTZxUK",
PgUEIgtkRA = "PgUEIgtkRA",
oIrEguZfeR = "oIrEguZfeR",
eFQRutdEnO = "eFQRutdEnO",
mdIDHwfVqa = "mdIDHwfVqa",
CItByJNRfc = "CItByJNRfc",
ttuhZGYjIq = "ttuhZGYjIq",
DtzJmUzEjD = "DtzJmUzEjD",
JeuuPVlrFK = "JeuuPVlrFK",
qqGsQsaZxs = "qqGsQsaZxs",
sNTjXcdJAR = "sNTjXcdJAR",
blijYshHfb = "blijYshHfb",
NIpQloAivP = "NIpQloAivP",
jFeZIoOmmp = "jFeZIoOmmp",
gZcsvsJiIL = "gZcsvsJiIL",
NDmJecEreI = "NDmJecEreI",
ztKpRsuAjq = "ztKpRsuAjq",
MOfcCYYrKJ = "MOfcCYYrKJ",
UqKorWvZnX = "UqKorWvZnX",
ybhzqQkIqt = "ybhzqQkIqt",
KUytyNkRzZ = "KUytyNkRzZ",
CyCSXspbrt = "CyCSXspbrt",
yZrVhXFqaS = "yZrVhXFqaS",
YeILrevSEU = "YeILrevSEU",
ZhfcueGBed = "ZhfcueGBed",
RTCAXTybHv = "RTCAXTybHv",
CuXauUeZcE = "CuXauUeZcE",
ijDuDCpKKl = "ijDuDCpKKl",
emeCAltQbi = "emeCAltQbi",
blRIwLjrOc = "blRIwLjrOc",
sBdMwTwKta = "sBdMwTwKta",
bkggwVHBBc = "bkggwVHBBc",
xrtIurwjHi = "xrtIurwjHi",
ZOwnelrhys = "ZOwnelrhys",
POcHAfOlWN = "POcHAfOlWN",
TdzYNogEVJ = "TdzYNogEVJ",
zDqALSteBz = "zDqALSteBz",
pqPpdEcSbk = "pqPpdEcSbk",
EqNusAzIOc = "EqNusAzIOc",
sVlIKZXrrE = "sVlIKZXrrE",
uUjrJBPFUn = "uUjrJBPFUn",
KuwyEboGGD = "KuwyEboGGD",
ZxZEsjeUUe = "ZxZEsjeUUe",
RotkEoqjcF = "RotkEoqjcF",
xuqgvnKmGQ = "xuqgvnKmGQ",
IffthBwRxb = "IffthBwRxb",
WKFWoXchzO = "WKFWoXchzO",
kTFxdXpLuo = "kTFxdXpLuo",
IeEiYyvREm = "IeEiYyvREm",
BJbfpIAoMH = "BJbfpIAoMH",
BXimttAjGk = "BXimttAjGk",
PmZEFOIefk = "PmZEFOIefk",
KnMVEAVUfQ = "KnMVEAVUfQ",
XzgqfxbFiY = "XzgqfxbFiY",
BKbItknbvV = "BKbItknbvV",
CjvhYApFif = "CjvhYApFif",
ubsOjWeOXr = "ubsOjWeOXr",
xncobnauQt = "xncobnauQt",
ikdrjjVXZk = "ikdrjjVXZk",
MvuxVtWXBf = "MvuxVtWXBf",
ZxRydrIMRh = "ZxRydrIMRh",
dwZWCbtGmt = "dwZWCbtGmt",
YWIjMwLQNe = "YWIjMwLQNe",
AGRFLUbeSe = "AGRFLUbeSe",
lxVvEIgKwm = "lxVvEIgKwm",
lZlpFquQWe = "lZlpFquQWe",
NcYDxRZzlK = "NcYDxRZzlK",
kzjjorTsVB = "kzjjorTsVB",
NcgPotHDsA = "NcgPotHDsA",
lSPIYkeYhb = "lSPIYkeYhb",
PJbpurWOtB = "PJbpurWOtB",
khULgEYFUT = "khULgEYFUT",
SnBMIgrzal = "SnBMIgrzal",
ePnuYnelGe = "ePnuYnelGe",
rBzylwhRuI = "rBzylwhRuI",
VScmhrvkyM = "VScmhrvkyM",
AbgeBHNyKG = "AbgeBHNyKG",
frroXFxdRn = "frroXFxdRn",
djfTfeCdtJ = "djfTfeCdtJ",
IrFVMaPxav = "IrFVMaPxav",
XXmztoddKW = "XXmztoddKW",
SrYrPAPPLe = "SrYrPAPPLe",
RVFkeQayHe = "RVFkeQayHe",
JrLZqqIsJU = "JrLZqqIsJU",
srkFbJdVdX = "srkFbJdVdX",
QGkOhAxPIy = "QGkOhAxPIy",
BooObiiiqa = "BooObiiiqa",
JIpOUuKIQr = "JIpOUuKIQr",
qOyCzzqQGw = "qOyCzzqQGw",
xsSZIyujBZ = "xsSZIyujBZ",
GKoqPvjXDV = "GKoqPvjXDV",
rTnRbJrRMV = "rTnRbJrRMV",
LrIxnhHweD = "LrIxnhHweD",
poEOwDmiuX = "poEOwDmiuX",
ryrWwXuqRR = "ryrWwXuqRR",
qeTUfuwpZP = "qeTUfuwpZP",
MerzRkwELC = "MerzRkwELC",
ILuBUirsDR = "ILuBUirsDR",
hHDssyqaqv = "hHDssyqaqv",
OjrGCXpJYc = "OjrGCXpJYc",
oorzEUbtDC = "oorzEUbtDC",
fpnfeOrReM = "fpnfeOrReM",
LqkGvuFgxD = "LqkGvuFgxD",
yyrEnvnhQb = "yyrEnvnhQb",
hauaHiuenx = "hauaHiuenx",
gFuzBZLuKb = "gFuzBZLuKb",
wXjiTGFNPd = "wXjiTGFNPd",
SVHNYgPiET = "SVHNYgPiET",
NwVOmmcQJz = "NwVOmmcQJz",
FwiZBVMOis = "FwiZBVMOis",
vBpgBtvUCL = "vBpgBtvUCL",
BVUrNIYvsP = "BVUrNIYvsP",
hZenkswmSB = "hZenkswmSB",
VpyNaUwmEK = "VpyNaUwmEK",
GIktmuBroM = "GIktmuBroM",
WPRTsqcPbW = "WPRTsqcPbW",
bJvIGSeLhp = "bJvIGSeLhp",
wtVZvJdzeU = "wtVZvJdzeU",
jTNtqNapHq = "jTNtqNapHq",
FiuiugMOMW = "FiuiugMOMW",
tEpdfiVlkb = "tEpdfiVlkb",
emMrlgkQNn = "emMrlgkQNn",
gLviTIzwFQ = "gLviTIzwFQ",
GHunhvRNqS = "GHunhvRNqS",
vnTFnaAOHz = "vnTFnaAOHz",
FQAyaMcIfF = "FQAyaMcIfF",
yCkeeTgdWw = "yCkeeTgdWw",
vrvNRtbabQ = "vrvNRtbabQ",
PQtzzSBIjm = "PQtzzSBIjm",
eGYmRZGSeu = "eGYmRZGSeu",
ajFutiPtkF = "ajFutiPtkF",
bOnifsrXZY = "bOnifsrXZY",
hCVoVuHBap = "hCVoVuHBap",
YRweCxReUO = "YRweCxReUO",
IBAXRKdpQo = "IBAXRKdpQo",
CyWcXYryAj = "CyWcXYryAj",
FQaxevuEVE = "FQaxevuEVE",
uuGarsRSpu = "uuGarsRSpu",
oAvsrELzQd = "oAvsrELzQd",
mioUustSfC = "mioUustSfC",
fMEekKXykP = "fMEekKXykP",
CyMENMoerr = "CyMENMoerr",
tHRCLKMEbh = "tHRCLKMEbh",
UByeuugoXM = "UByeuugoXM",
vCCMeMLEct = "vCCMeMLEct",
EOgYDLUSNw = "EOgYDLUSNw",
hsMeybUeVb = "hsMeybUeVb",
IrAdxyqhJY = "IrAdxyqhJY",
ekkBGKtjWe = "ekkBGKtjWe",
oqBwUQEBuq = "oqBwUQEBuq",
GKbHAzEBiU = "GKbHAzEBiU",
TPVIScPdiz = "TPVIScPdiz",
CZUlAfkeOA = "CZUlAfkeOA",
rtkEwrfeeu = "rtkEwrfeeu",
tQjnSvmAcP = "tQjnSvmAcP",
DOeKxzYIYO = "DOeKxzYIYO",
QoBKwjlrCY = "QoBKwjlrCY",
uPlPTnuIYm = "uPlPTnuIYm",
ehbCmzzXki = "ehbCmzzXki",
JfdkiNMizb = "JfdkiNMizb",
BpMSTWJfpw = "BpMSTWJfpw",
YSfYvNFVCd = "YSfYvNFVCd",
uXuAiZhdpT = "uXuAiZhdpT",
ENeQsoeSAC = "ENeQsoeSAC",
kmhvLVDive = "kmhvLVDive",
cfuuaDskzc = "cfuuaDskzc",
tFuRLJWVVa = "tFuRLJWVVa",
mALcfJRzBq = "mALcfJRzBq",
OqhpdrpNWl = "OqhpdrpNWl",
vEjDqyNyuG = "vEjDqyNyuG",
pWsrLTYHcF = "pWsrLTYHcF",
EUrAZWsSsV = "EUrAZWsSsV",
ChVxouxlmR = "ChVxouxlmR",
DHOrrexhJj = "DHOrrexhJj",
RPBlQCuTWB = "RPBlQCuTWB",
bUGJRgoIvs = "bUGJRgoIvs",
DtkPenFtRT = "DtkPenFtRT",
rrgUsvNoit = "rrgUsvNoit",
EvBueHKZXR = "EvBueHKZXR",
eQrAQDSHDr = "eQrAQDSHDr",
rmtdImeyRS = "rmtdImeyRS",
QAWoKtTVPR = "QAWoKtTVPR",
uZclDIrNFw = "uZclDIrNFw",
CbeYYZraec = "CbeYYZraec",
aVeWGhrome = "aVeWGhrome",
iIMxGuLLqt = "iIMxGuLLqt",
yueQfurnrQ = "yueQfurnrQ",
dlwgjAjJdA = "dlwgjAjJdA",
RJdMRgarNf = "RJdMRgarNf",
LGEyzJGqel = "LGEyzJGqel",
lYWSwgMEkc = "lYWSwgMEkc",
fwAZCelgFu = "fwAZCelgFu",
fwkblXTdYO = "fwkblXTdYO",
VHsIJMreaV = "VHsIJMreaV",
YDhfOFTlpP = "YDhfOFTlpP",
rQGAtMAter = "rQGAtMAter",
mrrUeuotlW = "mrrUeuotlW",
eSwHZEqeuB = "eSwHZEqeuB",
jtdDMYTuXP = "jtdDMYTuXP",
NRMrtzoXsG = "NRMrtzoXsG",
nFKwEeFRgk = "nFKwEeFRgk",
eEzDbfuClr = "eEzDbfuClr",
wjyUVLLINr = "wjyUVLLINr",
qKTNGPPymr = "qKTNGPPymr",
tQIJzlnpVb = "tQIJzlnpVb",
kXtOdTZrkw = "kXtOdTZrkw",
sBHNBUYqit = "sBHNBUYqit",
RvwptkPJqe = "RvwptkPJqe",
YAtIfRTwgb = "YAtIfRTwgb",
qxYoBBjUFf = "qxYoBBjUFf",
AbcAHxrEyM = "AbcAHxrEyM",
LeYrQRqIPW = "LeYrQRqIPW",
efpKMHqAiu = "efpKMHqAiu",
QkkoBjDAre = "QkkoBjDAre",
veWxuzUoMr = "veWxuzUoMr",
UBxEbyPrHZ = "UBxEbyPrHZ",
OtiAqWAbJr = "OtiAqWAbJr",
wlXokfjeFi = "wlXokfjeFi",
zRvCIDEleJ = "zRvCIDEleJ",
FzanflsANo = "FzanflsANo",
xSjZtHJKzh = "xSjZtHJKzh",
HNudzQjdwd = "HNudzQjdwd",
CbAZaUMwJM = "CbAZaUMwJM",
fjaOYRpfrD = "fjaOYRpfrD",
HwYZnhgmfp = "HwYZnhgmfp",
AOJxnFwYtL = "AOJxnFwYtL",
IRaSqTUnfX = "IRaSqTUnfX",
rRLSRrtXEa = "rRLSRrtXEa",
PZZjSxewBt = "PZZjSxewBt",
KeJiMLSVOZ = "KeJiMLSVOZ",
dPaLxcMnEP = "dPaLxcMnEP",
eDClMNuOoY = "eDClMNuOoY",
OCljnzflDC = "OCljnzflDC",
vAICympKgZ = "vAICympKgZ",
VHywtdvHCS = "VHywtdvHCS",
JCxTSDtjLR = "JCxTSDtjLR",
WrKyNHUHeX = "WrKyNHUHeX",
fZmINsFrWE = "fZmINsFrWE",
XyCQHgecYl = "XyCQHgecYl",
VcBAIqNJzx = "VcBAIqNJzx",
oFJNoRJqts = "oFJNoRJqts",
PCBAulMBhV = "PCBAulMBhV",
AydtNLiKwr = "AydtNLiKwr",
gtsNyjFuJz = "gtsNyjFuJz",
sZWQgaHIwj = "sZWQgaHIwj",
FzIafavhDw = "FzIafavhDw",
zisurgFKxX = "zisurgFKxX",
NZpvvuVTtC = "NZpvvuVTtC",
HemuEQAtmi = "HemuEQAtmi",
DalDpIOeKV = "DalDpIOeKV",
aAfysBFGYl = "aAfysBFGYl",
XqyjahPjPn = "XqyjahPjPn",
LnARDerUrK = "LnARDerUrK",
gtTEtzLRIu = "gtTEtzLRIu",
SrDqnAiTYJ = "SrDqnAiTYJ",
TdeXEHSirL = "TdeXEHSirL",
dLquHbwptF = "dLquHbwptF",
eBBSIvrmzT = "eBBSIvrmzT",
oecHgQIunu = "oecHgQIunu",
YngXNtSLGF = "YngXNtSLGF",
cnrFutciKT = "cnrFutciKT",
lcbPkHLLAU = "lcbPkHLLAU",
wqQRgbwZke = "wqQRgbwZke",
fvXpafgzkI = "fvXpafgzkI",
cyDBTuberV = "cyDBTuberV",
QLCZczNYle = "QLCZczNYle",
hCzWLqEtKo = "hCzWLqEtKo",
DfTLCnrouL = "DfTLCnrouL",
wnqJvPaCum = "wnqJvPaCum",
jqkLkDUAZy = "jqkLkDUAZy",
KAFbdjVKCq = "KAFbdjVKCq",
jAxoEakRCy = "jAxoEakRCy",
vWLuKrZdbb = "vWLuKrZdbb",
ukzkXTwroR = "ukzkXTwroR",
EnrwrCGErc = "EnrwrCGErc",
TiEuXKllsU = "TiEuXKllsU",
rfhQxeXtMI = "rfhQxeXtMI",
GtJPTLLxZL = "GtJPTLLxZL",
JiTrXQvyjF = "JiTrXQvyjF",
TqRyquLqYN = "TqRyquLqYN",
xZhYtbYwFP = "xZhYtbYwFP",
eVXPmhZrWF = "eVXPmhZrWF",
ethPflnTKu = "ethPflnTKu",
pKOlSndvyJ = "pKOlSndvyJ",
BWxZtrHHqu = "BWxZtrHHqu",
KzqAijnUVa = "KzqAijnUVa",
semGrYaHDk = "semGrYaHDk",
AahkeSdctZ = "AahkeSdctZ",
fddIyCGBoJ = "fddIyCGBoJ",
sqVoAsATwR = "sqVoAsATwR",
EWFhWtQJPt = "EWFhWtQJPt",
rgwUpeQBQk = "rgwUpeQBQk",
rKPIEXuify = "rKPIEXuify",
wleQKzeTQT = "wleQKzeTQT",
ramQUfbGPQ = "ramQUfbGPQ",
EufQViIeIh = "EufQViIeIh",
vJknuZQbfX = "vJknuZQbfX",
IvQBfAksjg = "IvQBfAksjg",
MyIAjsttbe = "MyIAjsttbe",
ftuUzhpuLm = "ftuUzhpuLm",
rEbUTrcHxr = "rEbUTrcHxr",
fQJIGDEwxd = "fQJIGDEwxd",
usomQYwXob = "usomQYwXob",
UVuhRtemCK = "UVuhRtemCK",
fqzopVSFjr = "fqzopVSFjr",
Ibntlmukrt = "Ibntlmukrt",
eLSbqRLaze = "eLSbqRLaze",
MPNCpZvbyV = "MPNCpZvbyV",
IaqktfuYBK = "IaqktfuYBK",
wntECeslNF = "wntECeslNF",
UMxwgFAksJ = "UMxwgFAksJ",
vochCtUVxl = "vochCtUVxl",
tllteROGeP = "tllteROGeP",
VaRWwWclfA = "VaRWwWclfA",
AQMogUISKI = "AQMogUISKI",
YmKJCFvpVA = "YmKJCFvpVA",
sbHWrwHwzE = "sbHWrwHwzE",
ZYmHxtpqQu = "ZYmHxtpqQu",
mEysSmRkPV = "mEysSmRkPV",
XyMoDiQCtv = "XyMoDiQCtv",
YpKDRxYZpi = "YpKDRxYZpi",
PEmauiYxJn = "PEmauiYxJn",
dfnwmsOjNb = "dfnwmsOjNb",
nQCrmNAvgK = "nQCrmNAvgK",
MWlJelrymu = "MWlJelrymu",
lmXSYwOKco = "lmXSYwOKco",
wtXXtBhPmv = "wtXXtBhPmv",
tVtSKpleJS = "tVtSKpleJS",
puUJGvZtFS = "puUJGvZtFS",
nnNtSfBGrX = "nnNtSfBGrX",
wYLoMTedrZ = "wYLoMTedrZ",
qmrEphaDtd = "qmrEphaDtd",
uxuWSKZMNm = "uxuWSKZMNm",
eHxaqPSeln = "eHxaqPSeln",
BtNrswDGXD = "BtNrswDGXD",
uATEdVuhJM = "uATEdVuhJM",
GZJdldzgDM = "GZJdldzgDM",
kUYgodnREt = "kUYgodnREt",
EIAkexfRKl = "EIAkexfRKl",
ByprbozKit = "ByprbozKit",